男子的死亡是否跟第二人有关	海龟汤的故事	T
餐厅里其实不卖海龟汤	海龟汤的故事	F
这个男人是不是因为有精神方面的疾病才自杀	海龟汤的故事	F
餐厅的店主是她前女友	海龟汤的故事	N
自杀是因为他脑子有病	海龟汤的故事	F
自杀和喝了海龟汤有关系	海龟汤的故事	T
男人在餐厅喝的真的是海龟汤	海龟汤的故事	T
男人在餐厅喝的这碗海龟汤是人肉做的	海龟汤的故事	F
他是不是吃过人	海龟汤的故事	T
海龟汤是否引起了他对海难的记忆	海龟汤的故事	T
他之前杀过海龟	海龟汤的故事	NF
做汤的厨师认识这个男人	海龟汤的故事	N
他因为吃了他妻子所以才自杀	海龟汤的故事	T
他以前是有出过海	海龟汤的故事	T
男人在餐厅是在等什么人	海龟汤的故事	N
他曾经吃了亲人	海龟汤的故事	T
他有欠债	海龟汤的故事	N
汤让他想起了什么	海龟汤的故事	T
他发现自己被绿了所以自杀	海龟汤的故事	F
男人以前喝过的海龟汤是他爱人的肉	海龟汤的故事	T
他自己一个人来这家餐厅的	海龟汤的故事	N
那天下雨	海龟汤的故事	N
在海难中失去的是自己最亲近的人	海龟汤的故事	T
汤是重点	海龟汤的故事	T
男人自杀是因为杀人或者犯了其他罪	海龟汤的故事	F
他之前来这喝过海龟汤	海龟汤的故事	F
有目击证人嘛	海龟汤的故事	N
他之前有误食过	海龟汤的故事	T
男人来到餐厅是不是没说话	海龟汤的故事	N
他是士兵	海龟汤的故事	N
他有家人死了	海龟汤的故事	T
在室内喝的海龟汤	海龟汤的故事	N
他喝过同样味道的汤	海龟汤的故事	F
海龟汤让他意识到了什么	海龟汤的故事	T
他是不是打过仗	海龟汤的故事	N
他想要睡觉	海龟汤的故事	N
他在荒岛上经历了什么	海龟汤的故事	T
他的死跟海有关	海龟汤的故事	T
男人最近受到了打击	海龟汤的故事	N
海龟汤放了致幻药物喝了会使人精神不由自己控制导致自杀	海龟汤的故事	F
男人之前喝过有人肉的汤	海龟汤的故事	T
海龟汤是他做的	海龟汤的故事	F
男人生病了	海龟汤的故事	N
他以前养过海龟	海龟汤的故事	N
他之前吃了人肉以为是海龟肉	海龟汤的故事	T
他被通缉了	海龟汤的故事	N
他自杀是因为另一个人	海龟汤的故事	T
他之前和家人一起来喝过	海龟汤的故事	N
他喝醉了	海龟汤的故事	N
这个汤勾起了回忆	海龟汤的故事	T
这个男人自杀的原因是否是加入邪教组织或被洗脑	海龟汤的故事	F
他在碗底看到了信息	海龟汤的故事	N
海龟汤里有药导致他自杀	海龟汤的故事	F
男人之前喝过假的海龟汤	海龟汤的故事	T
他曾经遭遇海难并且有同伴一起	海龟汤的故事	T
这个海龟是神仙	海龟汤的故事	N
他以前见过这只海龟	海龟汤的故事	N
他是抱着寻求真相的想法去喝汤的	海龟汤的故事	N
他曾经把别的食材做的汤误以为是海龟汤	海龟汤的故事	T
他的枪是合法所得	海龟汤的故事	N
有别人威胁他	海龟汤的故事	F
他认识店里某个人	海龟汤的故事	N
这碗汤里有人体组织	海龟汤的故事	F
他吃完海龟汤心情不好	海龟汤的故事	T
他的生活是否发生变故	海龟汤的故事	T
他是发现了这碗汤里有人肉	海龟汤的故事	F
这碗汤的材料是海龟	海龟汤的故事	T
他这个汤和之前吃的人肉味道不一样	海龟汤的故事	T
他喝之前是不是就想自杀	海龟汤的故事	N
他对汤过敏	海龟汤的故事	N
男人以前喝的是假的海龟汤	海龟汤的故事	T
海龟汤的价格很高	海龟汤的故事	N
海龟汤是可以喝的汤	海龟汤的故事	T
海龟被这个男人虐待过	海龟汤的故事	N
男人不知道汤有毒	海龟汤的故事	N
因为海龟汤太好喝 一激动就按了手枪结果自己就死了	海龟汤的故事	F
男人是逃犯	海龟汤的故事	N
汤里有壳	海龟汤的故事	N
他经历过海难	海龟汤的故事	T
他喝汤的时候周围有别人	海龟汤的故事	N
男人发现海龟汤跟记忆中的一样	海龟汤的故事	F
海龟是他的宠物	海龟汤的故事	N
男人是自愿自杀的	海龟汤的故事	T
汤有妈妈的味道想妈妈了就自杀去找妈妈了	海龟汤的故事	F
这个他是这个男人	海龟汤的故事	T
海龟救过他的命	海龟汤的故事	N
他害怕大海	海龟汤的故事	N
自杀是因为餐具有问题	海龟汤的故事	F
餐厅的海龟汤是毒药	海龟汤的故事	N
海龟汤里的是真的海龟	海龟汤的故事	T
他是环保主义者	海龟汤的故事	N
他有精神疾病	海龟汤的故事	N
他之前是gay	海龟汤的故事	N
海龟是男人养的	海龟汤的故事	N
他现在有女朋友	海龟汤的故事	N
他之前有过和她老婆或者女朋友一起流落在荒岛或者绝境	海龟汤的故事	T
他和同伴一起来的	海龟汤的故事	N
他是盲人	海龟汤的故事	N
男子痛恨那家餐厅	海龟汤的故事	N
枪是他自己带的	海龟汤的故事	N
男人喜欢喝汤	海龟汤的故事	N
自杀是因为他没钱付款	海龟汤的故事	F
是海边餐厅	海龟汤的故事	N
装海龟汤的容器底部是不是有字	海龟汤的故事	N
他妻子去世了没有生还	海龟汤的故事	T
他曾经喝过海龟汤但不是这个味道	海龟汤的故事	T
海龟汤是一种隐喻不是真的汤	海龟汤的故事	F
自杀是因为餐厅有问题	海龟汤的故事	F
他是动物保护者	海龟汤的故事	N
汤是黑色的	海龟汤的故事	N
男人有特异功能	海龟汤的故事	N
汤是他自己煮的	海龟汤的故事	F
男子的妈妈死了	海龟汤的故事	N
海龟汤里除了海龟还有别的材料	海龟汤的故事	N
男子吃过人肉	海龟汤的故事	T
海龟汤和他想象的不一样	海龟汤的故事	T
男人是否受伤	海龟汤的故事	N
他是不是眼睛受了伤导致暂时看不见	海龟汤的故事	N
男子经历海难的时候喝过海龟汤	海龟汤的故事	T
汤很烫	海龟汤的故事	N
他是被谋杀了	海龟汤的故事	F
海龟汤太好喝了好喝到他想自杀	海龟汤的故事	F
以前喝的海龟汤是妻子的肉做的	海龟汤的故事	T
同伴给他喝过海龟汤和他现在喝的海龟汤味道不一样	海龟汤的故事	T
他有自杀倾向嘛	海龟汤的故事	N
自杀是被迫的	海龟汤的故事	F
枪是偷来的	海龟汤的故事	N
他进去餐厅之前嗑药了	海龟汤的故事	N
他有没有疾病	海龟汤的故事	N
是因为他没钱结账才自杀	海龟汤的故事	F
他患有绝症	海龟汤的故事	N
他曾和朋友一起被困孤岛了	海龟汤的故事	T
汤是服务员端上来的	海龟汤的故事	N
汤是餐厅做的	海龟汤的故事	T
海龟汤是男性特殊部位熬制的汤	海龟汤的故事	F
男人吃饭的外面有警察	海龟汤的故事	N
这家餐厅里有凶手	海龟汤的故事	N
他生在海边	海龟汤的故事	N
他的爱人死了么	海龟汤的故事	T
自杀是喝汤之后才决定的	海龟汤的故事	T
是男人自己的枪	海龟汤的故事	N
海龟汤很难喝	海龟汤的故事	N
他对海龟汤过敏	海龟汤的故事	N
他想到了之前的人之前的人死了	海龟汤的故事	T
海难的时候是海龟救了你	海龟汤的故事	F
他以前去过餐厅	海龟汤的故事	N
服务员他认识	海龟汤的故事	N
他吃过人肉	海龟汤的故事	T
他之前喝过人肉汤	海龟汤的故事	T
他忘记枪里有子弹所以误杀	海龟汤的故事	F
他家人在海难中死了	海龟汤的故事	T
他知道枪里有子弹	海龟汤的故事	N
海龟汤和男人自杀有直接联系	海龟汤的故事	T
做汤的海龟对男人来说很重要	海龟汤的故事	N
他对某件事情感到愧疚	海龟汤的故事	T
这是他为自己点的最后的晚餐	海龟汤的故事	F
男人自杀是因为喝了海龟汤	海龟汤的故事	T
他的恋人曾经给他做饭	海龟汤的故事	N
他常来这家餐厅	海龟汤的故事	N
男人以前是个渔夫	海龟汤的故事	N
男人是自杀	海龟汤的故事	T
海龟汤不能喝	海龟汤的故事	F
他喝过他妻子的肉做的汤	海龟汤的故事	T
男生错误地估计水深了	水草	N
男生自责因为某些原因自杀了	水草	T
渔夫说的话刺激到了男生	水草	T
男生曾下水救人	水草	T
水草很像一个人的头发	水草	T
男生救人失败了	水草	T
男生的前女友落入水中男生当时以为是水草其实是女生的头发	水草	T
男生之前犯过罪	水草	N
渔夫告诉男生一些信息	水草	T
男生跳河后渔夫在喊救命	水草	N
渔夫说的话和这条河有关	水草	T
水草很像钱所以男人跳河了	水草	F
男士要骗保险所以跳河	水草	F
之前这个地方死过对男生来说很重要的人	水草	T
男生爱的人死了	水草	T
男生以前是和一个女生一起来的	水草	T
河里有宝藏所以男子跳河了	水草	F
水草很像男生过去吃的某种东西	水草	F
水草象征着绿帽子	水草	N
河里死过人	水草	T
和渔夫的聊天内容导致了男生跳河	水草	T
渔夫说这个河里没有水草	水草	T
水草像蛇	水草	F
渔夫提到了男生的故人	水草	F
渔夫强迫他跳	水草	F
渔夫想让男生死	水草	N
男生以为水草是人手	水草	F
渔夫说岸上有怪兽	水草	F
渔夫说河里的水草能帮人获取财富	水草	F
渔夫是个杀手	水草	N
是渔夫说话的内容让男生跳河的嘛	水草	T
男生把水里的人当成别的东西而没成功救人	水草	T
男生的女朋友曾经溺水过	水草	T
男生想起了爱人	水草	T
男生来过这条河	水草	T
男生回来了	水草	N
渔夫说了人身攻击的话	水草	F
渔夫是故意说那句话的	水草	N
男生认识渔夫	水草	N
男生跳河有第三者的原因	水草	T
渔夫威胁他导致他跳河	水草	F
渔夫说完话后，男生是想救人所以跳河	水草	F
男生曾经落水	水草	T
他女朋友是在这里死的	水草	T
男生和之前那个死在河里的人认识	水草	T
渔夫说河里有好东西	水草	F
渔夫说的话撒谎了	水草	F
河里有大鱼所以男生跳河	水草	F
女友间接被男友害死了	水草	T
水草像宝藏	水草	F
水很浅	水草	N
男生的女朋友死于落水了	水草	T
水草像渔夫	水草	F
男生有原因跳河	水草	T
渔夫是警察	水草	N
男生出于好心救人而跳河	水草	F
男生以为河里的水草是鬼	水草	F
男生是鬼	水草	N
男生的女朋友死了	水草	T
男生跳河是因为河里面有宝贝	水草	F
跳河是受到了什么刺激	水草	T
男生跳河为了帮渔夫	水草	F
渔夫说的话里提到了某个人	水草	F
渔夫是鬼	水草	N
渔夫和他说这条河里没有鱼	水草	F
这是男人计划好的嘛	粉色连衣裙的女人	F
男人家中还有其他人	粉色连衣裙的女人	T
吵架是因为男人	粉色连衣裙的女人	T
邻居有特殊癖好	粉色连衣裙的女人	T
他们是故意演戏争吵	粉色连衣裙的女人	F
长发女人是男人女儿	粉色连衣裙的女人	F
女人把男人杀了	粉色连衣裙的女人	F
争吵是因为女子的穿着打扮而起的	粉色连衣裙的女人	T
男人把女人囚禁起来了	粉色连衣裙的女人	F
长发女人是邻居的出轨对象	粉色连衣裙的女人	F
那个女生跟邻居有关系	粉色连衣裙的女人	T
两人是情侣关系	粉色连衣裙的女人	F
粉色连衣裙是他们的纪念品男人因为赌博喝酒被长发女人看到了长发女生就跟男子争吵了起来这日子没法过了长发女人只好剪断他们的纪念品和长发来表达自己要重新过一段生活	粉色连衣裙的女人	F
男邻居是不是死了	粉色连衣裙的女人	F
粉色这个颜色重要	粉色连衣裙的女人	F
他们是在嫖娼	粉色连衣裙的女人	F
他有一晚上都在冲马桶	粉色连衣裙的女人	N
一共只有两个人	粉色连衣裙的女人	T
领居家昨晚是两个男人	粉色连衣裙的女人	F
摔东西的是邻居	粉色连衣裙的女人	T
男人伪装成女人和邻居谈恋爱	粉色连衣裙的女人	F
女人没有受伤	粉色连衣裙的女人	T
女人是邻居	粉色连衣裙的女人	T
女人是被男人胁迫了	粉色连衣裙的女人	F
那天晚上传来的吵架声是和不支持他女装的人吵的对	粉色连衣裙的女人	T
连衣裙和长发是邻居的	粉色连衣裙的女人	T
女的是去剪头发	粉色连衣裙的女人	F
粉红连衣裙和长发是男人剪碎的	粉色连衣裙的女人	F
女人就是隔壁的邻居	粉色连衣裙的女人	T
男人是不是家暴妻子	粉色连衣裙的女人	F
那个浓妆艳抹的人是男人假扮的	粉色连衣裙的女人	T
头发是假发	粉色连衣裙的女人	T
妻子和小三打起来	粉色连衣裙的女人	F
邻居的职业重要	粉色连衣裙的女人	F
那个女生怀孕了	粉色连衣裙的女人	F
两人争吵是不是引发了什么后果	粉色连衣裙的女人	T
女人把自己误杀了	粉色连衣裙的女人	F
吵架的是邻居和长发女人	粉色连衣裙的女人	F
她们的争执是因为情感问题	粉色连衣裙的女人	F
女人是假扮的	粉色连衣裙的女人	T
邻居女装	粉色连衣裙的女人	T
男人强奸了这个女人	粉色连衣裙的女人	F
女人被碎尸了	粉色连衣裙的女人	F
男人是理发师	粉色连衣裙的女人	N
垃圾袋里是尸体	粉色连衣裙的女人	F
男人是邻居的恋人 他假扮成女人来到邻居家 邻居将其杀害	粉色连衣裙的女人	F
邻居压力大抑郁症	粉色连衣裙的女人	N
粉色连衣裙是男人剪碎的	粉色连衣裙的女人	F
女人死了	粉色连衣裙的女人	F
连衣裙是男人剪的	粉色连衣裙的女人	F
他们吵架是因为父亲	粉色连衣裙的女人	F
女人和邻居是同一个人	粉色连衣裙的女人	T
长发女人是女人	粉色连衣裙的女人	F
男人反对长发女人的工作而争执并把她头发剪了	粉色连衣裙的女人	F
那女人是他妈	粉色连衣裙的女人	F
粉色连衣裙和长发是那个女人自己剪的	粉色连衣裙的女人	T
邻居除了男人还有别人	粉色连衣裙的女人	T
邻居就是连衣裙女人	粉色连衣裙的女人	T
女人是性工作者	粉色连衣裙的女人	F
女人是真的女人	粉色连衣裙的女人	F
女人是男人的女朋友	粉色连衣裙的女人	F
邻居这个男人扮女人	粉色连衣裙的女人	T
这一对男女是长期亲密关系	粉色连衣裙的女人	F
年轻男人是不是杀了长发女人	粉色连衣裙的女人	F
那件被剪碎的连衣裙是那个女人身上穿的那一套么	粉色连衣裙的女人	T
女子是不是妓女	粉色连衣裙的女人	F
邻居深夜真的摔了东西	粉色连衣裙的女人	T
邻居是给女人理发	粉色连衣裙的女人	F
有人死了	粉色连衣裙的女人	F
女人是前妻	粉色连衣裙的女人	F
女人与男人一夜情	粉色连衣裙的女人	F
男的是双性恋长发女人实际是男人两人是情侣关系期间男的劈腿一个女人被其情侣发现因此其假扮成女装揭穿了男人劈腿的事实两人发生争吵男人剪碎了她的裙子女人剪掉了男人的头发	粉色连衣裙的女人	F
这个女人是男人女装的	粉色连衣裙的女人	T
邻居是同性恋	粉色连衣裙的女人	N
那天晚上是男的和别人争吵	粉色连衣裙的女人	T
长发女人是邻居的妻子么	粉色连衣裙的女人	F
他俩是不是夫妻	粉色连衣裙的女人	F
那男人还有个老婆咯	粉色连衣裙的女人	N
女人是他朋友	粉色连衣裙的女人	F
是因为东西被剪碎了而争吵	粉色连衣裙的女人	F
裙子和头发是男人的	粉色连衣裙的女人	T
男人和女人在玩cosplay	粉色连衣裙的女人	F
这男人和女人是一个人	粉色连衣裙的女人	T
女人被侵犯了	粉色连衣裙的女人	F
故事里没有人死	粉色连衣裙的女人	T
邻居喜欢穿女装	粉色连衣裙的女人	T
女子是鬼	粉色连衣裙的女人	F
男人杀死了女人	粉色连衣裙的女人	F
那晚邻居家还有别人	粉色连衣裙的女人	T
邻居真的是独居	粉色连衣裙的女人	T
文中有四个人	粉色连衣裙的女人	F
邻居与争吵有关	粉色连衣裙的女人	T
邻居有家室	粉色连衣裙的女人	F
儿子是异装癖然后被母亲发现了所以在吵架	粉色连衣裙的女人	T
发现我屋子里有人	交换照片	T
照片的背景很吓人	交换照片	T
他背后有人	交换照片	T
他是我的老师	交换照片	N
网友的照片是我的照片	交换照片	T
故事中有人死亡	交换照片	F
他的照片是动物	交换照片	F
照片很血腥	交换照片	F
照片内容很重要	交换照片	T
相片中的细节有异常	交换照片	T
他发的照片是一个人上吊了	交换照片	F
他是我认识的人	交换照片	F
照片是用ai合成的	交换照片	N
网友的样子是我的小时候的样子	交换照片	N
网友是猫猫在乱按键盘	交换照片	F
照片里面包含我家的部分背景	交换照片	T
他活着	交换照片	T
照片里的其他东西有异常	交换照片	T
照片是自己识人的人	交换照片	N
照片里有我熟悉的东西	交换照片	T
聊天平台正经	交换照片	N
他的照片里出现了和我相关的画面	交换照片	T
他照片里的背景是在我家	交换照片	T
他发的是遗照	交换照片	F
网友的性别重要	交换照片	F
网友的照片是我身边死去的人的照片	交换照片	F
对方是杀人犯拿了我的照片要来杀我	交换照片	F
网友在我家	交换照片	T
网友在他床底	交换照片	T
网友是我被我杀了的前女友	交换照片	F
照片是我的自拍	交换照片	T
他长得和我一模一样	交换照片	F
网友长得不好看	交换照片	F
照片是巨尸体	交换照片	F
当我把自己的照片发过去之后他又把我的那张照片发了回来我觉得很奇怪仔细看了一下才发现在我身后的床下露出了一只脚这个网友就躲在我房间里	交换照片	T
他的照片在我熟悉的地方拍摄	交换照片	T
房间里不止我一个人	交换照片	T
我在做梦	交换照片	F
他是我同学	交换照片	N
照片里的是不是有什么让我害怕的东西	交换照片	T
照片上是未来的我	交换照片	F
我感到害怕和他的照片背景有关	交换照片	T
照片是在我家拍的	交换照片	T
是自己的隐私照片	交换照片	F
网友的照片是否和自己已故的亲人有关	交换照片	F
网友是通缉犯	交换照片	N
认识的人且已经离世	交换照片	F
照片上是小时候的我	交换照片	F
照片很诡异	交换照片	T
他认识网友	交换照片	N
照片里有鬼魂	交换照片	F
他在求救	交换照片	F
照片中的人是我妈	交换照片	N
网友的脚出现在了我的照片里	交换照片	T
他拍的是我家的照片	交换照片	T
他是死人	交换照片	F
照片里的他在杀人	交换照片	F
网友在我房间	交换照片	T
照片上的背景在坟墓里	交换照片	F
网友监视我	交换照片	T
他没有脸	交换照片	F
网友是我熟悉的人	交换照片	N
照片是通过望远镜拍的	交换照片	F
网友在偷窥我	交换照片	T
是锯木头声被侏儒误认为成什么了	马戏团	F
盲人侏儒准备变高	马戏团	F
木屑是他锯的	马戏团	F
木头是死因	马戏团	F
死者有竞争对手	马戏团	T
盲人侏儒是不是想用木屑干点什么	马戏团	F
他不是真的侏儒	马戏团	F
别人锯东西了	马戏团	T
他对木头有癖好	马戏团	F
木屑的产生是因为在家练习马戏团的节目	马戏团	F
他用木屑垫脚	马戏团	F
他给自己做了个棺材	马戏团	F
他是为了更好的前途在家里努力但是失误	马戏团	F
死者想要一笔赔款嘛	马戏团	F
是不是因为侏儒的身份让他被误认为童工	马戏团	F
他家里没有木质家具	马戏团	F
盲人侏儒被马戏团开除了	马戏团	F
他家是木头搭建的	马戏团	N
他的拐杖短了	马戏团	F
他的死亡是不是与别人有关	马戏团	T
那他是不是肚子里都是木屑	马戏团	N
他吃了木屑	马戏团	F
这个故事还有第二个人	马戏团	T
木屑是他的双腿	马戏团	F
侏儒锯死了人	马戏团	F
别人提前布置好了	马戏团	T
马戏团有两个侏儒	马戏团	T
他以为自己不会受欢迎了	马戏团	T
盲人是在制作上吊用到的木凳所以满地都是木屑	马戏团	F
是假死	马戏团	F
他想长高	马戏团	F
盲人以为自己不能在马戏团工作了	马戏团	T
木屑是从家具上来的	马戏团	T
马戏团要裁员	马戏团	T
木屑是盲人自己造成的	马戏团	F
木屑是拐杖	马戏团	F
盲人侏儒被当做玩偶了	马戏团	F
他想搬木头但是他太矮了够不着只能每次抠下来一点木屑然后他拿了把椅子过来想踩在椅子上搬结果不小心掉下来死了	马戏团	F
是不是有人为了让他放弃某样东西而布局	马戏团	T
他想做木头义眼	马戏团	F
侏儒死因和锯子有关	马戏团	F
他累死了	马戏团	F
侏儒是自杀的	马戏团	T
木头有毒	马戏团	N
木屑来自地板	马戏团	F
他身上有外伤	马戏团	N
是因为是侏儒的原因或身高的原因	马戏团	T
盲人在练习马戏的时候死了	马戏团	F
他以为是马戏团的道具实际上是锯子	马戏团	F
他的同事把他家里的家具锯矮了	马戏团	T
他的死亡是不是与他是侏儒有关	马戏团	T
他正在做木工	马戏团	F
是家塌了	马戏团	F
该起事件是意外发生的	马戏团	F
侏儒的家具被改造了	马戏团	T
他是不是想逃出家里	马戏团	F
他知道自己是侏儒	马戏团	T
是不是有人去过侏儒家	马戏团	T
他是真的盲人	马戏团	T
是侏儒在刨木头	马戏团	F
自杀与身高相关	马戏团	T
木屑是凶器	马戏团	N
周围的环境变了	马戏团	T
是另一个侏儒导致他的死亡	马戏团	T
盲人侏儒过劳而死	马戏团	F
锯木头的时候锯成地板了	马戏团	F
周围的木屑是他自己搞出来的	马戏团	F
我看过这个故事有人偷偷把家具截短了侏儒以为自己长高了会失业自杀了	马戏团	T
有人锯木头了	马戏团	T
侏儒砍掉家具后被砸死了	马戏团	F
木屑是他自己制造的	马戏团	F
有鬼魂	马戏团	F
盲人侏儒以为自己长高了马戏团不要自己	马戏团	T
他是被关起来了	马戏团	F
木屑是屋子裡的嗎	马戏团	T
侏儒竞争不过别人所以自杀了	马戏团	F
盲人侏儒是不是在家里训练	马戏团	N
他是心脏病死的	马戏团	F
他想变矮 锯断了自己的腿	马戏团	F
是侏儒家塌了	马戏团	F
他被木头绊倒砸死了自己	马戏团	F
他试图增高	马戏团	F
他是在制作什么东西的时候不慎死亡的	马戏团	F
故事里有别人	马戏团	T
盲人侏儒在马戏团的工作是走独木桥	马戏团	N
他家离马戏团近	马戏团	N
木屑是盲人倒地造成的	马戏团	F
侏儒是从高空坠落	马戏团	F
受害者的死亡跟同行或同事有关	马戏团	T
为了表演某个节目而锯木头	马戏团	F
侏儒锯什么东西反被锯子锯死了	马戏团	F
他的表演是踩高跷	马戏团	N
他吸入了木屑	马戏团	F
木屑是酒瓶塞子	马戏团	F
有第二个人	马戏团	T
盲人侏儒发现自己长高了	马戏团	T
侏儒的眼盲是否促进了他的死亡	马戏团	T
是马戏团其他的侏儒干的	马戏团	T
他的死和马戏团工作有关系	马戏团	T
我以为自己在长高不能挣钱然后自杀了	马戏团	T
有人给他做假肢	马戏团	F
他是做木工的时候死的	马戏团	F
木屑是盲人侏儒造成的么	马戏团	F
马戏团有需要自制道具的机会	马戏团	N
家具变矮了他以为自己长高了	马戏团	T
盲人第一次知道自己是侏儒	马戏团	F
侏儒是想上吊	马戏团	F
是因为他的家具有关系	马戏团	T
他被人抛尸在家里用木屑盖住了	马戏团	F
侏儒被当成木头被刨了	马戏团	F
木屑是不是来自家具	马戏团	T
他是不小心锯坏了地板摔倒下一层摔死的嘛	马戏团	F
是在工作中发生了意外	马戏团	F
侏儒用削尖的木头自杀的	马戏团	N
他自己把自己锯了	马戏团	F
他是中毒而死的	马戏团	N
侏儒以为自己不够格但是实际上是鞋子的问题	马戏团	F
木屑不是人为的	马戏团	F
死亡是否跟工作的去留有关	马戏团	T
盲人侏儒是不是在家里做了很多记号	马戏团	N
他忍受不了侏儒的身份	马戏团	F
家具后面藏着人	马戏团	F
两个侏儒只能留下一个	马戏团	T
木屑是因为家具损坏了	马戏团	T
动物杀的	马戏团	F
他的死因与动物有关	马戏团	F
他锯木头粉尘过敏	马戏团	N
他是养狮子的	马戏团	F
他在马戏团有竞争对手	马戏团	T
房间里有血	马戏团	N
侏儒做木工活	马戏团	F
他不认识数字	十八楼	F
因为十八层地狱电梯中对十八楼的标识不同	十八楼	N
他是为了假装自己全程都是爬楼梯上来的	十八楼	F
18楼是顶楼	十八楼	N
小明不直接上十八楼是因为害怕	十八楼	F
小明是老年人	十八楼	F
小明年龄与这件事有关	十八楼	T
十八楼有他害怕的东西	十八楼	F
小明的身高按不了18楼	十八楼	T
1层是不是最高	十八楼	F
他去15楼是因为没带雨伞按不到电梯键	十八楼	T
家里人不让小明直接上来	十八楼	F
他家有三层	十八楼	F
是因为不能直接到十八楼	十八楼	F
他要造成他不在18楼的证据	十八楼	F
小明晴天按不到18,下雨天可以用伞按下18楼	十八楼	T
他怕碰到别人	十八楼	F
小明有的时候按不到十八楼的按钮	十八楼	T
因为有一台电梯只能上15楼	十八楼	F
有人帮小明按按钮	十八楼	F
因为16楼的人很墨迹	十八楼	F
小明要减肥	十八楼	N
十五楼有他的房子	十八楼	F
因为18楼地狱	十八楼	F
是因为电梯超载	十八楼	F
小明是残疾	十八楼	F
小明和家长住在一起	十八楼	N
他能按但是没按	十八楼	F
小明按不到电梯按键	十八楼	T
小明逃课	十八楼	N
小明记错了楼层	十八楼	F
有时候他摁不到18楼	十八楼	T
小明的年龄与楼层数有关	十八楼	F
这栋楼里曾经发生过命案	十八楼	N
电梯按键是完好的	十八楼	T
小明封建迷信	十八楼	F
有多个电梯	十八楼	N
是因为电梯有问题	十八楼	F
他爸妈离婚分居	十八楼	N
小明个子矮	十八楼	T
小明是有意为之	十八楼	F
下雨天小明带伞可以按到18楼	十八楼	T
小明认识十五楼的人	十八楼	N
小明是不想被人看见么	十八楼	F
是因为有时候电梯不运行到18楼	十八楼	F
十五到十八楼有什么事情需要小明做	十八楼	F
是为了躲避某个人	十八楼	F
有两部电梯	十八楼	F
十八楼的按键有时候是坏的	十八楼	F
小明为了逃避监控	十八楼	F
小明在谈恋爱	十八楼	N
十五楼有小明喜欢的东西或人	十八楼	F
小明是否穿高跟鞋	十八楼	F
小明家里有家人	十八楼	N
小明在十五楼长大	十八楼	N
小明疯了	十八楼	F
小明15岁时则到15楼	十八楼	N
他是外卖员	十八楼	F
第十八层的电梯门是好的	十八楼	T
小明有幽闭恐惧症	十八楼	F
小明是狗	十八楼	F
十八楼不是固定存在的	十八楼	F
18楼的按键对于小明来说太高	十八楼	T
他要偷窥十五楼的人	十八楼	F
跟小明性别有关	十八楼	F
有其他人	十八楼	N
他选择到十五楼和到十八楼的日子和当天天气有关	十八楼	T
小明和父母回家的时候父母按18楼可以直接到家只有他一个人回家的时候因为身高很矮自己只能按到15楼的按钮所以只能先乘到15楼再爬楼梯到十八楼	十八楼	F
他手上有某些东西就可以按到十八楼	十八楼	T
小明是老人痴呆	十八楼	F
小明跟父母一起住	十八楼	N
他在楼梯间藏了东西	十八楼	N
有人死了	十八楼	F
小明是成年人	十八楼	F
电梯总是能到达十八楼	十八楼	T
他会有危险	十八楼	F
小明是傻逼	十八楼	F
是为了掩盖自己住哪层	十八楼	F
小明是人	十八楼	T
先乘电梯到15楼是某种暗号么	十八楼	F
小明是不是对数字很敏感	十八楼	N
有第二个人	十八楼	F
小明在15楼能遇到过去的自己	十八楼	F
小明先到十五楼是因为身高够不到	十八楼	T
楼梯是有什么特别之处	十八楼	F
他不住18楼	十八楼	F
爬楼梯是为了做什么事情	十八楼	F
第十五到十八楼之间有什么他不想见到的东西	十八楼	N
跟邻居有关	十八楼	F
16楼和17楼经常出事故	十八楼	F
有人要杀他	十八楼	F
小明有时候穿增高鞋垫了	十八楼	F
求救的人是摔死的	山顶	T
死的是敲门的人	山顶	T
是主角开门导致那人坠落山下摔死的	山顶	T
房间在悬崖上	山顶	T
他不开门会死	山顶	F
是自杀	山顶	F
他开门的时候意识清醒	山顶	N
门是朝外开的尸体就是敲门的人因为开门被推下山	山顶	T
敲门的不是人	山顶	F
故事里有第三者	山顶	F
他是瞎子	山顶	F
开门的人幻听了	山顶	F
昨晚有人向他求救	山顶	T
山脚的人用石头砸门	山顶	F
死了的那个人是被动物咬死的	山顶	F
敲门声是坠落声	山顶	F
死者是从山顶掉下去的	山顶	T
死的人被狼吃了	山顶	F
敲门的被拖走了	山顶	F
这个人误杀了死者	山顶	T
这个住在山顶的人是凶手	山顶	T
敲门时门口有人	山顶	T
敲门声是人摔下去发出的	山顶	F
大风撞门造成敲门的声音	山顶	F
死者是爬上山敲门的	山顶	T
死的人是独自居住在山顶小屋里的人	山顶	F
山顶刮风了	山顶	N
门是朝外开的	山顶	T
死尸敲门的时候趴在地上屋子主人没有看见	山顶	F
死者在敲门前是否活着	山顶	T
是敲门的人或小屋里的人死了	山顶	T
是自然灾害	山顶	F
他他打开门把敲门的人不小心推到了山脚下	山顶	T
是房主杀了人	山顶	T
死尸是山顶小屋的主人	山顶	F
他们认识	山顶	N
那人死和开门有关系	山顶	T
狼敲的门	山顶	F
他开门时候门把敲门的人给打到山底摔死了	山顶	T
门把人推下去了	山顶	T
打开门没有看到他,于是他冻死了	山顶	F
死尸是敲门的人	山顶	T
死者想敲门求救但是在门开之前被凶手杀了	山顶	F
有人进他的屋子了	山顶	F
敲完门害怕,自己掉下去了	山顶	F
他是自杀	山顶	F
死尸跟主角有关	山顶	N
死者是不是冻死的	山顶	F
死的人是住的人	山顶	F
死者是不是很矮	山顶	N
男的死了成了大体老师	条件	T
有人死了	条件	T
男生偷偷进的学校	条件	F
男生进大学参观	条件	F
男生逼迫女生改志愿了	条件	F
男的不是以学生的身份进的学校	条件	T
男生是女生寝室的管理员	条件	F
进入大学时已经很大年纪了	条件	F
因为女孩不喜欢男孩	条件	F
男生超常发挥	条件	F
男生是以一种特别的方式进的这所大学	条件	T
男生还活着	条件	F
大学的招生系统是被黑了	条件	F
男子在大学成为了大体老师	条件	T
男生的关心让女生喘不过气	条件	F
男生是用女生的大脑考上的大学	条件	F
女生和男生一起去了差学校	条件	F
男子强奸了她	条件	F
男生是不是穷追不舍	条件	F
女生受到了物理伤害	条件	F
男生交换了两人的试卷	条件	F
他们最后成为情侣了	条件	F
男生喜欢别人了	条件	N
他遗体捐献	条件	T
大学是医学院嘛	条件	T
女生是自己独立完成的考试	条件	N
考上了大学女生依旧不愿意跟男生在一起	条件	N
女孩学习成绩非常好	条件	N
女生是不想做他女朋友	条件	F
男生把女生分数改了	条件	F
女子有精神疾病	条件	N
一起进的学校不是好学校	条件	N
男人作弊坐牢了	条件	F
男生是通过成绩以外的方式进入大学的	条件	T
女生杀人了	条件	F
一座大学不同校区	条件	F
他绑架女生进大学	条件	F
男生是去大学做保安	条件	F
男生确实死了,在女生学校里做解剖道具	条件	T
虽然考上了同一所大学但是女子不打算遵守诺言男子便一直跟踪女子窥视女子最终女子疯了	条件	F
男生是学校的厨师	条件	F
女生考的医学院男生是解刨的尸体	条件	T
他们进的是聋哑人或残疾人大学	条件	F
男生想伤害女生	条件	F
男生偷了女子的录取通知书	条件	F
进入的大学不是女子心仪的大学	条件	N
男生是学校的保洁	条件	F
男生和女生有亲属关系	条件	N
有没有第三者	条件	F
女生装疯卖傻	条件	F
男生为了和女生上一个大学把自己的脑子和别人的换了	条件	F
男生看到女生有男朋友	条件	F
男生把女生的成绩拉低了	条件	F
男生变成了尸体	条件	T
女生疯了是因为压力太大	条件	F
这所大学只有女生能进	条件	F
女生复读过	条件	N
男生是不是不是以学生身份和女生进入同一所大学的	条件	T
是老年大学	条件	F
男生一直拖着女子让他辅导自己	条件	F
男生其实是女生	条件	F
女生疯掉的原因和高考相关	条件	F
男生陷害女生让女生成绩也不好	条件	F
男生是否活着	条件	F
因为女孩落榜了	条件	F
女生故意写错了题 结果男生比她考得好	条件	F
男生修改了女生的试卷分数	条件	F
女子复读了很多年才考入同一所大学	条件	F
女子没想过男生能考上	条件	F
进入大学的第一天点名时女生发现原来男生是自己的亲生兄弟	条件	F
男生在高考前夕已经由于意外死亡但是女生在大学里却看见了男生	条件	F
男生和女生有血缘关系	条件	N
男孩捐献了他的遗体	条件	T
男生靠其他方式进入那所大学	条件	T
女孩子是医科学校	条件	T
男子成绩超过了她	条件	F
男的成了解剖用的尸体	条件	T
男生被大学录取了	条件	F
男子是跨性别者	条件	F
男生出车祸了	条件	N
男生是否使用某种手段让女生成绩变差	条件	N
他顶替女生进的这个大学	条件	F
小王恐高	滑梯	N
小孩是他失散多年的精神儿子	滑梯	F
小王是头朝下滑下来的	滑梯	N
这个滑梯有安全问题	滑梯	F
看到的东西跟滑梯无关	滑梯	T
这个小孩死了	滑梯	F
小王滑下来看到了长大了的自己	滑梯	T
小王看到的是和惊恐的小孩看到的相似的东西	滑梯	T
小孩是曾经的小王	滑梯	T
滑梯里有血	滑梯	F
他穿越了	滑梯	T
和公园的绿化带有关	滑梯	F
发现自己变小了	滑梯	T
小孩站在那	滑梯	F
滑下来小王变成那个小孩了	滑梯	T
滑梯是正常的	滑梯	F
格子衫和程序员有关系	滑梯	T
因为他看见杀人犯了	滑梯	F
小王滑下去之后发现自己坐在一片儿童公墓里	滑梯	F
格子衫小朋友是小王	滑梯	T
小王看到自己也变成小孩儿了	滑梯	T
小王穿越了	滑梯	T
看到了加班回家的自己	滑梯	T
小孩玩滑梯摔死了 小王滑滑梯看到了他	滑梯	F
小王看到的东西重要	滑梯	T
他平常以为的格子衫小孩其实是他看错了离的近了才发现那并不是小孩	滑梯	F
滑梯很吓人	滑梯	F
小孩穿的不是格子衫 是带有血迹的衣服	滑梯	F
滑梯上有伤害人的东西	滑梯	F
小孩惊恐是因为玩滑梯	滑梯	F
在滑梯上能看到犯罪发生	滑梯	F
格子衫小孩和小王有关系	滑梯	T
话题很高	滑梯	N
滑梯有问题	滑梯	T
小王有危险	滑梯	F
滑梯附近有命案发生	滑梯	N
看到的是他自己	滑梯	T
滑梯下面是悬崖	滑梯	F
他不能离开滑梯了	滑梯	F
小王结婚了	滑梯	N
还有其他人	滑梯	F
小王是在滑梯滑完后看到的东西	滑梯	T
滑梯旁边是镜子	滑梯	N
小王知道自己可能会遭遇不测	滑梯	F
滑梯一直在变长	滑梯	F
小孩的身份重要	滑梯	T
这个事情的发生跟滑梯有关系	滑梯	T
此故事中有人死亡	滑梯	F
滑梯滑下来的人会死	滑梯	F
格子衫的小孩很重要	滑梯	T
滑梯滑下来会让人变小	滑梯	T
看到小孩埋尸体	滑梯	F
有人死了	滑梯	F
小孩感到惊恐的原因和小王一样	滑梯	T
滑梯是时光机	滑梯	T
小王发现裤子拉链开了	滑梯	F
小王看到了尸体	滑梯	F
滑梯杀死过人	滑梯	N
看到了滑梯油漆没干	滑梯	F
小王看到的东西是人类	滑梯	T
小孩每天站在那里重要	滑梯	N
孩子的惊恐和小王有关	滑梯	T
小孩不是人	滑梯	F
滑的过程中看见了什么东西	滑梯	T
滑梯下面是棺材	滑梯	F
小孩穿的衣服重要	滑梯	T
我是盲人政府所认为的异类	视力	T
看到有之前看得见的人写的提示	视力	T
视力恢复的人会有危险	视力	T
恢复视力的人会被当成异类	视力	T
恢复视力的人需要去杀害其他人	视力	F
地球上剩余的人是怪物	视力	F
我看到话说明除了我还有人不是盲人	视力	T
那句话很重要	视力	T
那句话是只有我能看到的	视力	F
盲人组织了政府	视力	T
大家会解刨不是盲人的人	视力	T
新政府会杀死能看见的人	视力	T
那句话是只写给我看的	视力	F
我看到的话是盲人写的	视力	F
恢复视力的人会被盲人拉去做研究	视力	T
恢复视力变哑巴	视力	F
恢复视力的人如果被别人知道会被杀掉	视力	T
我是唯一恢复视力的人	视力	F
他是看到了威胁他的话	视力	F
是关于为什么变成盲人的话	视力	F
盲人统治了世界 会猎杀看得见的人	视力	T
我长出了新的眼睛	视力	F
政府要把恢复视力的人送进实验室	视力	T
告诉别人会被杀	视力	T
有其他人看得见这句话	视力	T
因为说话的人会让灾难再次发生	视力	F
大家的眼睛是真的盲了	视力	T
我不能被发现是人群中的异类	视力	T
世界上只能存在一个视力正常的人	视力	F
那句话是 说话就又变盲人了	视力	F
如果我把消息告诉其他人我会害了自己	视力	T
看到那句话的人会死	视力	F
那句话重要	视力	T
所有到现在还看不见的人都是作恶多端的人	视力	F
这个世界只剩我一个人了	视力	F
我不把消息告诉别人是为了自己的安全	视力	T
写那句话的人死了	视力	N
政府要抓恢复视力的人	视力	T
新政府要杀能看得到的人	视力	T
我恢复视力是人为的	视力	F
恢复视力被当作导盲犬	视力	F
灾难是人为的	视力	N
所有人都死了	视力	F
我原本就看得见但我以为自己看不见	视力	F
有一个人弄瞎了所有人	视力	F
不是盲人的人是带来灾难的凶手	视力	F
世界上只剩下他一个人类了他一说话就会被人发现	视力	F
地球上还有除自己以外的人类	视力	T
如果我把消息告诉大家我会再度变成盲人	视力	F
我不说消息的原因重要	视力	T
新政府导致所有人失明	视力	F
我视力恢复的原因是杀死别人	视力	F
盲人是不是组织了政府	视力	T
他是看到了警告他的话	视力	T
异类会被研究	视力	T
告诉大家我就会死	视力	T
盲人变成了所谓的正常人是嘛	视力	T
死刑犯的愿望是见见外面的太阳	死刑犯跟恶魔	F
行人捂着鼻子是因为看到了死刑犯夸张的死状	死刑犯跟恶魔	F
他越狱失败了	死刑犯跟恶魔	F
他许愿变成隐形人	死刑犯跟恶魔	T
恶魔帮助他的代价是从他身上获取一些东西	死刑犯跟恶魔	F
他的棺材放在了马路边	死刑犯跟恶魔	F
恶魔死了	死刑犯跟恶魔	F
死刑犯许愿要造福社会	死刑犯跟恶魔	F
他想让所有人都看到他	死刑犯跟恶魔	F
死刑犯无罪释放	死刑犯跟恶魔	F
气味来源是活物	死刑犯跟恶魔	F
死刑犯尸体在公共场所	死刑犯跟恶魔	T
他的特异功能是净化空气	死刑犯跟恶魔	F
臭味儿来自每个人身上是狐臭	死刑犯跟恶魔	F
每个人都能看到他死尸的样子	死刑犯跟恶魔	F
恶魔吃了死刑犯	死刑犯跟恶魔	F
他死后尸体被别人放在路上	死刑犯跟恶魔	F
许愿空气是臭的	死刑犯跟恶魔	F
他没有死	死刑犯跟恶魔	F
行人闻到了难闻的味道	死刑犯跟恶魔	T
他的尸体后来被运送出监狱了	死刑犯跟恶魔	F
他向恶魔许愿要自由	死刑犯跟恶魔	F
死刑犯获救但是代价是变成恶魔的样子	死刑犯跟恶魔	F
死刑犯让恶魔在路上拉屎	死刑犯跟恶魔	F
死刑犯变成臭鼬出来了	死刑犯跟恶魔	F
他隐身越狱	死刑犯跟恶魔	T
尸体腐烂发出的臭味	死刑犯跟恶魔	T
这个特异功能是给死刑犯的尸体的	死刑犯跟恶魔	F
行人是因为死刑犯才捂鼻子	死刑犯跟恶魔	F
别人是不是看不见他	死刑犯跟恶魔	T
死刑犯希望恶魔把所有人的鼻子都割掉	死刑犯跟恶魔	F
气味和犯人的死有关	死刑犯跟恶魔	T
罪犯死了	死刑犯跟恶魔	T
这种臭味有来源	死刑犯跟恶魔	T
他死了所以他成功离开了监狱	死刑犯跟恶魔	F
走在街上的行人是因为闻到臭味才面露难色	死刑犯跟恶魔	T
许愿让大家记住他	死刑犯跟恶魔	F
罪犯变成尸体了	死刑犯跟恶魔	T
他死在大街上	死刑犯跟恶魔	T
死刑犯许的愿望本身是离开监狱	死刑犯跟恶魔	F
男子许愿是为了逃出监狱	死刑犯跟恶魔	T
他是希望自己遗臭万年	死刑犯跟恶魔	F
死刑犯尸体完整	死刑犯跟恶魔	F
死刑犯越狱了	死刑犯跟恶魔	T
他以空气的形式存活下去	死刑犯跟恶魔	F
捂着鼻子是尸体的臭味	死刑犯跟恶魔	T
男人还活着	死刑犯跟恶魔	F
闻到味道的人会死	死刑犯跟恶魔	F
他死在一个路上 没有人能看到他	死刑犯跟恶魔	T
他希望他死在大街上	死刑犯跟恶魔	F
死刑犯许的愿望是吃螺蛳粉	死刑犯跟恶魔	F
他被车撞了	死刑犯跟恶魔	T
异味来自他	死刑犯跟恶魔	T
他是因为气味而被判刑的	死刑犯跟恶魔	N
他是为了保护上级	死刑犯跟恶魔	F
死刑犯许的愿望内容重要	死刑犯跟恶魔	T
他的愿望是这个世界变臭	死刑犯跟恶魔	F
他为了别人才许愿	死刑犯跟恶魔	F
他躲在有味道的地方	死刑犯跟恶魔	F
他让恶魔杀人了	死刑犯跟恶魔	F
死刑犯从下水道跑了	死刑犯跟恶魔	N
他的愿望中与他自己死后的身体状况有关	死刑犯跟恶魔	F
行人闻到了臭味	死刑犯跟恶魔	T
他许愿从下水道逃跑	死刑犯跟恶魔	F
愿望的实现是因为交换了什么东西	死刑犯跟恶魔	F
恶魔把附近的厕所都停水了	死刑犯跟恶魔	F
他许愿自己死后可以当一具僵尸	死刑犯跟恶魔	F
死刑犯的愿望是尸体味道很大	死刑犯跟恶魔	F
他许愿自己死了以后还能行走	死刑犯跟恶魔	F
他让恶魔杀了很多人然后那些人的尸体散发的味道让人难受	死刑犯跟恶魔	F
他的愿望与他家人有关	死刑犯跟恶魔	F
他要求自己的尸体迅速消失	死刑犯跟恶魔	F
这个死刑犯许愿永远不死因此他的尸体一直没有分解然后尸体腐烂的臭味让所有人都面露难色	死刑犯跟恶魔	F
他的血变成雨	死刑犯跟恶魔	F
恶魔理解错了他的意思	死刑犯跟恶魔	F
男子隐身之后被车撞了	死刑犯跟恶魔	T
死刑犯想逃出监狱	死刑犯跟恶魔	T
他的尸体在路上走	死刑犯跟恶魔	F
这个愿望一定程度上促使罪犯的死亡	死刑犯跟恶魔	T
故事中有超现实的元素	死刑犯跟恶魔	T
他许愿复活	死刑犯跟恶魔	F
他的尸体在城市的各个角落	死刑犯跟恶魔	F
愿望的代价跟气味有关	死刑犯跟恶魔	F
死刑犯想有超能力	死刑犯跟恶魔	T
恶魔给了这个人特异功能么	死刑犯跟恶魔	T
行人捂着鼻子是因为闻到了难闻的气味	死刑犯跟恶魔	T
死刑犯想长生不老	死刑犯跟恶魔	F
恶魔让死刑犯变成尸体了	死刑犯跟恶魔	F
他许愿别人闻不到他的特殊气味	死刑犯跟恶魔	F
死刑犯的尸体在路上	死刑犯跟恶魔	T
在他死后进入自己的身体出监狱	死刑犯跟恶魔	F
死刑犯许愿要变成垃圾桶	死刑犯跟恶魔	F
行人是否必须经过一个特定的地方才能闻到味道	死刑犯跟恶魔	T
死刑犯出车祸了	死刑犯跟恶魔	T
男人是向恶魔许愿不要死	死刑犯跟恶魔	F
他的愿望和他的尸体有关	死刑犯跟恶魔	F
死刑犯喜欢榴莲	死刑犯跟恶魔	N
他的尸体在马路上供人参观	死刑犯跟恶魔	F
死刑犯的尸体出现在了路上	死刑犯跟恶魔	T
他希望能够寄生在行人的鼻子里	死刑犯跟恶魔	F
愿望是变成恶魔	死刑犯跟恶魔	F
许愿的内容重要	死刑犯跟恶魔	T
是他的愿望让路上变臭的	死刑犯跟恶魔	F
小朋友的妈妈是她真正的妈妈	四岁的妈妈	F
小朋友实际上是患有侏儒症的妈妈家里四岁的妈妈才是原本的小朋友	四岁的妈妈	F
小朋友所谓的妈妈还活着	四岁的妈妈	T
孩子故意把老师骗到家里	四岁的妈妈	T
妈妈是被诱拐过来的	四岁的妈妈	T
她的妈妈是生物	四岁的妈妈	T
小朋友有妹妹	四岁的妈妈	N
妈妈是未婚早孕	四岁的妈妈	F
小朋友妈妈的智商水平是只有四岁年龄的智商水平	四岁的妈妈	F
他们家对数字的定义不一样	四岁的妈妈	F
小朋友的妈妈实际上4百岁了	四岁的妈妈	F
四岁的是他妹妹	四岁的妈妈	F
她所说的妈妈被拐来四年了	四岁的妈妈	T
她所说的妈妈是成年人	四岁的妈妈	T
妈妈是外观像像四岁	四岁的妈妈	F
她的妈妈是侏儒症	四岁的妈妈	F
这是她的恶作剧	四岁的妈妈	F
他的妈妈套上了儿童的皮套	四岁的妈妈	F
小朋友被家暴了	四岁的妈妈	N
小朋友帮着拐骗幼儿园老师	四岁的妈妈	T
她的妈妈返老还童了	四岁的妈妈	F
小朋友骗老师去家里	四岁的妈妈	T
她所谓的妈妈有遭遇过不好的事情	四岁的妈妈	T
他妈妈是骨灰	四岁的妈妈	N
小朋友冒充小孩骗人回家囚禁	四岁的妈妈	T
她没有父母	四岁的妈妈	N
小朋友不是五岁她给她哥找女老师囚禁	四岁的妈妈	T
小朋友的年龄是假的	四岁的妈妈	T
身份证年龄有问题	四岁的妈妈	F
全家只有四根手指	四岁的妈妈	F
所谓的妈妈是被绑架四年	四岁的妈妈	T
她所谓的爸爸在家	四岁的妈妈	T
我看到的是妈妈的墓碑	四岁的妈妈	F
四岁是女人被囚禁的时间	四岁的妈妈	T
小朋友真的觉得自己的妈妈只有四岁	四岁的妈妈	F
小朋友和她所谓的妈妈有血缘关系	四岁的妈妈	F
她妈妈是二月二十九日出生	四岁的妈妈	N
小女孩真的5岁	四岁的妈妈	F
我看到了一个四岁小孩的尸体	四岁的妈妈	F
妈妈是被囚禁的老师	四岁的妈妈	T
她所说的妈妈被囚禁	四岁的妈妈	T
她的妈妈是毛绒娃娃	四岁的妈妈	F
4岁是指妈妈来到这个家的年数么	四岁的妈妈	T
小朋友让我家访是想救妈妈	四岁的妈妈	F
小朋友分不清母亲到底多少岁	四岁的妈妈	F
小朋友的妈妈在她四岁的时候去世了	四岁的妈妈	F
他的妈妈长着一张儿童的脸	四岁的妈妈	F
小朋友真实年龄是大人但是外表像小孩	四岁的妈妈	T
小朋友说的是实话	四岁的妈妈	F
小朋友真实年龄不是五岁	四岁的妈妈	T
他爸爸有恋童癖	四岁的妈妈	F
小朋友的心理年龄五岁但实际上已经很大了	四岁的妈妈	F
小朋友真正的妈妈死了	四岁的妈妈	N
惊恐的一幕是指有人死了么	四岁的妈妈	F
小朋友说的妈妈是她实际上的妈妈	四岁的妈妈	F
她妈妈是死了之后到现在已经过了四年了	四岁的妈妈	F
我在小朋友家看到尸体了	四岁的妈妈	F
小朋友算数的方式和普通人不一样	四岁的妈妈	F
小孩不会数数	四岁的妈妈	F
我看到了小孩子的生母	四岁的妈妈	F
小朋友说谎了	四岁的妈妈	T
妈妈真的四岁	四岁的妈妈	F
小朋友是从四岁的母亲的肚子里拿出来的	四岁的妈妈	F
小朋友得了长不大的病	四岁的妈妈	T
那个妈妈是她的妹妹	四岁的妈妈	F
她爸爸娶了个四岁的老婆	四岁的妈妈	F
小朋友家有宠物	四岁的妈妈	N
她妈妈有智力障碍或者侏儒	四岁的妈妈	F
她的妈妈是童养媳	四岁的妈妈	F
给她哥找女老师囚禁	四岁的妈妈	T
她奶奶生了个孩子四岁	四岁的妈妈	F
四岁并不是四岁而是进行了四年的什么东西的意思	四岁的妈妈	T
她所谓的爸爸犯罪了	四岁的妈妈	T
她所说的妈妈是幼师	四岁的妈妈	T
她妈妈被砍成了矮个子	四岁的妈妈	F
小朋友有双胞胎	四岁的妈妈	N
小朋友在闹着玩	四岁的妈妈	F
小女孩是不是遭受家暴让她精神失常	四岁的妈妈	N
妈妈是闰年出生的	四岁的妈妈	N
妈妈有精神问题	四岁的妈妈	N
惊恐是因为她妈妈的年龄	四岁的妈妈	F
我在害怕的东西是否跟鬼魂相关	四岁的妈妈	F
她们在玩过家家	四岁的妈妈	F
我看到她妈妈的遗照	四岁的妈妈	F
她的妈妈是被迫生下她的	四岁的妈妈	N
她把妹妹称为妈妈	四岁的妈妈	F
小朋友的爸爸在家	四岁的妈妈	N
我惊恐是因为她家里有野兽	四岁的妈妈	F
小朋友杀人了	四岁的妈妈	N
她妈妈只能数到4	四岁的妈妈	F
她说的妈妈是画上的人	四岁的妈妈	F
我看到了一个尸体	四岁的妈妈	F
家里是不是有4岁的人	四岁的妈妈	F
她的妈妈是被拐卖来的么	四岁的妈妈	T
他跟我按的同一层电梯	数数	F
他把我绑架了	数数	F
他数的是还活着的人数	数数	F
他还活着	数数	T
对面楼杀人犯杀人我报警数杀人犯所在楼层告诉警方结果杀人犯看到了我在数我在的楼层想过来杀我	数数	T
我在数凶手的楼层	数数	T
是类似于俄罗斯转盘的死亡游戏	数数	F
我和他在爬楼梯	数数	F
我看到对面做了什么事他意识到被发现随后开始数我的楼层	数数	T
他在数杀过的人	数数	F
我目击了犯罪	数数	T
房间只有我一个人	数数	N
他在天上	数数	F
我看到他杀人了但他在数我的楼层	数数	T
我们是小孩子	数数	N
我有可能要出事	数数	T
在数被困了多少天	数数	F
他在数我身上的东西	数数	F
凶手数数是不是与我相关	数数	T
他透过窗户数数	数数	T
我和他在同一层楼	数数	N
是不是我杀了人	数数	F
我毛骨悚然是因为他	数数	T
他数数跟我的生命安全相关	数数	T
做迷藏躲起来数数他同样在数数	数数	F
我数楼层是因为我要给警方提供杀人犯所在楼层信息	数数	T
我现在危险	数数	T
数字是楼层	数数	T
我欠他钱了	数数	F
是炸弹倒计时	数数	F
我毛骨悚然是因为他数的数跟我有区别	数数	F
他在倒数	数数	N
他在我旁边	数数	F
他是真实的人	数数	T
他对我有威胁	数数	T
我在数手指头他在数脚指头	数数	F
和电梯有关	数数	F
他是镜像	数数	F
是在数时间	数数	F
他在数我的死亡倒计时	数数	F
两人认识	数数	F
他在数我家的楼层	数数	T
他是杀人犯	数数	T
我是能隔着楼层听到他的话	数数	F
我在数尸体数时尸体也在数数	数数	F
凶手数的是不是尸块	数数	F
他可能想害我	数数	T
他是我的幻想	数数	F
他是在数我是第几个要被杀的	数数	F
我跳楼了	数数	F
他数楼层数是为了寻找合适的位置跳楼	数数	F
我数的是人数	数数	F
他们两个在数电梯	数数	F
两人数的是同一个东西	数数	T
我们是在坐电梯	数数	F
他本来不会数数	数数	F
他是不是在数我的位置	数数	T
他在数楼层足够你跳楼后死亡	数数	F
数的是手指	数数	F
我数楼层是为了告诉警察	数数	T
他在数我的楼层	数数	T
我目睹了杀人现场 我报警要说楼层 凶手数楼层要杀我	数数	T
他在数人头	数数	F
我们住在同一栋楼	数数	F
他是危险的人	数数	T
数数是在倒计时	数数	F
他数的数超出了电梯的楼层	数数	F
他和你是夫妻	数数	F
他在确定我的位置	数数	T
有人死了	数数	T
我被绑架了 我在数自己在第几层以获取救援他在数还有几秒我会死	数数	F
他数的是负数	数数	F
他在数日子	数数	F
他是在数杀人收了多少钱	数数	F
我目睹杀人现场	数数	T
他在确认我住第几层	数数	T
我在报警	数数	T
他数哪层哪层死人	数数	F
他邀请你到他的楼层	数数	F
他数的数是错的	数数	F
红色高跟鞋有毒女人穿了便死掉了	高跟鞋	F
背自己的鞋跟杀死了	高跟鞋	F
是高跟鞋而导致身高过高	高跟鞋	T
女士穿着高跟鞋工作	高跟鞋	T
女士是杂技演员	高跟鞋	T
她是要和男朋友约会	高跟鞋	F
女人是模特	高跟鞋	F
她是被一个变态跟踪了	高跟鞋	F
女士结婚了	高跟鞋	N
女士是马戏团演员	高跟鞋	T
红色高跟鞋一定程度上导致了这次意外	高跟鞋	T
女士身高发生变化导致死亡	高跟鞋	T
有野兽攻击红色东西	高跟鞋	F
她死的时候穿着高跟鞋	高跟鞋	T
这次穿的鞋跟太高了	高跟鞋	T
故事人物只有这个女士	高跟鞋	F
女子头上顶苹果	高跟鞋	T
女子是杂戏团的	高跟鞋	T
她死的时候在家里	高跟鞋	F
她是要结婚了	高跟鞋	N
凶手是鞋店老板	高跟鞋	F
犯人是店员	高跟鞋	F
她死了	高跟鞋	T
故事出现了第二个人	高跟鞋	T
凶手留下的鞋	高跟鞋	F
有人把她认成了别人	高跟鞋	F
女人的职业是跳钢管舞	高跟鞋	F
她意外死去是因为穿着高跟鞋	高跟鞋	T
她的职业是带有表演性质的	高跟鞋	T
杀手是红绿色盲本来要杀绿鞋	高跟鞋	F
凶手因为她买了这双鞋而杀她	高跟鞋	F
女人穿着高跟鞋表演杂技	高跟鞋	T
女人是空姐	高跟鞋	F
和她的家人有关	高跟鞋	F
凶手是陌生人	高跟鞋	F
鞋子是凶器	高跟鞋	F
她要从高空摔落	高跟鞋	F
她买鞋的时候被凶手看见了	高跟鞋	F
高跟鞋很显眼	高跟鞋	N
她的高跟鞋有什么问题	高跟鞋	F
女士因为穿高跟鞋在楼梯上摔落	高跟鞋	F
女人在夜店上班	高跟鞋	F
有人杀了她	高跟鞋	T
是在路上被抢劫了	高跟鞋	F
有其他人因为红色高跟鞋而死	高跟鞋	F
她是画家	高跟鞋	F
跟红色有关系	高跟鞋	F
死亡现场只有她一个人	高跟鞋	F
女人的职业特殊	高跟鞋	T
她的死与红色高跟鞋有关	高跟鞋	T
她专门穿着这双鞋自杀了	高跟鞋	F
女人的工作有些危险	高跟鞋	T
是高跟鞋卡了井盖	高跟鞋	F
她的死是谋杀	高跟鞋	F
是不是穿高跟鞋比之前高了点	高跟鞋	T
她不喜欢高跟鞋	高跟鞋	N
她的搭档是色盲	高跟鞋	N
她要跳舞	高跟鞋	F
是交通事故	高跟鞋	F
穿上高跟鞋变高了所以崴脚摔倒去世	高跟鞋	F
女士被仇杀	高跟鞋	F
女士购买了这双高跟鞋	高跟鞋	T
她抢了别人东西	高跟鞋	F
她住的地方有很多下水道	高跟鞋	N
她没穿过高跟鞋	高跟鞋	F
被连环杀手盯上了	高跟鞋	F
鞋子是死人遗物	高跟鞋	F
同事扔飞刀因为她变高了结果死了	高跟鞋	T
她要参加婚礼	高跟鞋	F
她的工作是销售	高跟鞋	F
故事只有女主一个人	高跟鞋	F
她的职业必须穿高跟鞋	高跟鞋	N
女士过去表演时不穿高跟鞋	高跟鞋	F
女士在工作的时候穿了高跟鞋	高跟鞋	T
高跟鞋断了	高跟鞋	F
她的死亡和她的职业有关	高跟鞋	T
凶手眼睛有毛病	高跟鞋	F
她晚上要去的地方不适合穿高跟鞋	高跟鞋	F
鞋坏了	高跟鞋	F
女人是他杀	高跟鞋	T
高跟鞋是凶手的	高跟鞋	F
高跟鞋导致身高变化	高跟鞋	T
穿高跟鞋开车出车祸了	高跟鞋	F
女士之前没有穿过高跟鞋	高跟鞋	F
脚上伤口因为鞋是红色的没发现	高跟鞋	N
她因为穿高跟鞋不便于跑步而意外去世	高跟鞋	F
女士是死于意外	高跟鞋	T
女子如果不穿这双高跟鞋就可能不太会死	高跟鞋	T
红色高跟鞋是目标	高跟鞋	F
正巧一辆失控的汽车飞驰而过导致了她的不幸身亡	高跟鞋	F
她听蔡健雅的歌	高跟鞋	N
女士的职业重要	高跟鞋	T
女士是被飞刀刺中身亡的	高跟鞋	T
女人高跟鞋比平时穿的高了	高跟鞋	T
她从事的工作是具有危险性的么	高跟鞋	T
高跟鞋有过别的主人	高跟鞋	N
女人被吊死	高跟鞋	F
是由熟人杀的她	高跟鞋	T
女士很爱穿高跟鞋	高跟鞋	N
女士被别人陷害	高跟鞋	F
红色其实是凶兆	高跟鞋	F
女人被飞刀杀了	高跟鞋	T
是家里的人杀死她的	高跟鞋	F
高跟鞋是她自己穿的	高跟鞋	T
她自己要穿高跟鞋	高跟鞋	T
她是在楼梯里遇害的	高跟鞋	F
女人的死和超自然力量有关系	高跟鞋	F
高跟鞋的声音会让她精神混乱	高跟鞋	N
女士一般在夜晚上班	高跟鞋	N
她鞋劣质	高跟鞋	N
所以她会因为身高变高而死亡	高跟鞋	T
是发生在马路上	高跟鞋	F
女人在是做高空工作的	高跟鞋	F
高跟鞋一定程度上导致她的死亡	高跟鞋	T
有规定不能穿红鞋子	高跟鞋	N
女人是自杀的	高跟鞋	F
女人工作需要穿高跟鞋	高跟鞋	N
高跟鞋是记号 引起误会 被杀	高跟鞋	F
她是色盲	高跟鞋	N
买鞋原因重要	高跟鞋	F
凶手是随机杀人	高跟鞋	F
女士参与表演飞刀	高跟鞋	T
女士这次穿的高跟鞋跟平常不一样	高跟鞋	T
女士过去穿平底鞋	高跟鞋	N
故事里有一名连环杀人犯只杀穿高跟鞋的女性	高跟鞋	F
她穿红色高跟鞋是为了给情人看	高跟鞋	F
是意外杀人	高跟鞋	T
牛会杀了她	高跟鞋	F
女人是杀手	高跟鞋	F
女人是马戏团的表演飞刀打苹果的演员高跟鞋改变了她的身高她的搭档飞飞刀的时候原本该打在头上苹果的刀直接刺进了女人的脑门上女人当场毙命	高跟鞋	T
红色高跟鞋死人身上拔下来的	高跟鞋	F
女人是做嫖娼的	高跟鞋	F
女人是色盲	高跟鞋	N
女人的工作不允许她穿红色高跟鞋	高跟鞋	N
高跟鞋预示着女人就要被工作上的人杀死	高跟鞋	T
她是会因为穿高跟鞋开车而没办法踩刹车出车祸死亡	高跟鞋	F
女士买鞋的时候知道会死	高跟鞋	F
女子最后死了	高跟鞋	T
她在马戏团工作	高跟鞋	T
她是自杀	高跟鞋	F
是预示的星期二	高跟鞋	F
这个男人脸色惨白是因为身体不舒服	午夜列车	F
根据老婆婆的话她推断出来老婆婆是她认识的人了	午夜列车	F
男生是医生	午夜列车	N
男人能看见别人的寿命 这个婆婆满七十岁死亡	午夜列车	F
婆婆5分钟内会死	午夜列车	T
列车不是真的列车	午夜列车	F
男子觉得奶奶有点吓人	午夜列车	F
婆婆在69死亡	午夜列车	T
男人死亡是婆婆导致的	午夜列车	F
男子知道这些乘客的年龄是因为某种客观的信息来源例如车票或身份证	午夜列车	F
男人能看到别人死亡的年龄	午夜列车	T
他做了一个午夜列车的梦其实都是自己吓自己	午夜列车	F
男子是神	午夜列车	N
还有五分钟男子就要死了	午夜列车	N
男子有读心术知道奶奶马上要死了	午夜列车	F
男子要杀一个马上70岁的人	午夜列车	F
列车已经脱轨了	午夜列车	F
他所看到婆婆的寿命只有69	午夜列车	T
婆婆很害怕男子	午夜列车	N
婆婆有特殊身份	午夜列车	F
男子没猜对婆婆的年龄	午夜列车	F
婆婆死亡年龄是70	午夜列车	F
该男子的超能力和婆婆相关	午夜列车	F
年龄重要	午夜列车	T
超能力是看见死期他发现大家都快死了推断出列车要出车祸	午夜列车	T
这个男人是卖保险的	午夜列车	N
列车晚点了	午夜列车	N
男人能看到老太婆70岁死	午夜列车	F
猜错乘客年龄会有惩罚	午夜列车	F
男人推测自己的生命即将结束	午夜列车	T
男子的超能力是预知未来	午夜列车	F
男子知道自己的死亡时间在五分钟后	午夜列车	F
男子的超能力是识别别人的年龄	午夜列车	F
婆婆撒谎了	午夜列车	F
车上有人虚报年龄	午夜列车	F
他看到婆婆的死亡年龄是69但是婆婆5分钟后就70岁了说明这辆列车5分钟内会出事车上的人都会死	午夜列车	T
他的特异功能在婆婆身上出现了错误的判断	午夜列车	F
男子得到预言车上婆婆70岁的时候列车会出事故	午夜列车	F
听完婆婆的回答其他人脸色惨白	午夜列车	N
男子能看到凡人看不到的东西	午夜列车	T
列车要去哪重要	午夜列车	F
列车方向是不是开反了	午夜列车	N
男子会死	午夜列车	T
车上的人数比男人的问题数量少	午夜列车	N
婆婆真的是69岁	午夜列车	T
他是死神	午夜列车	F
马上车就要出事故这个男子是困在循环里	午夜列车	F
男子看见人头上有字	午夜列车	N
跟车上的人对话之前 男子知道自己在几岁死去	午夜列车	F
男人的工作和年纪有关	午夜列车	F
男子带着特殊任务坐车	午夜列车	F
列车5分钟内就要出事故了	午夜列车	T
男子是否此前曾搭上一模一样的列车	午夜列车	N
这个列车是真实的	午夜列车	T
列车在12:00会出事故	午夜列车	N
男子以为自己能看见别人年龄实际上是是死亡年龄	午夜列车	F
男子有乘客的信息	午夜列车	F
车上的人都是鬼魂	午夜列车	F
该男子是否有天堂或地狱的特殊身份	午夜列车	F
他真的是纯靠猜猜对年龄的	午夜列车	F
列车上时间故障了	午夜列车	F
婆婆午夜过后年龄的变化会让列车改变目的地	午夜列车	F
车上有骨灰盒	午夜列车	N
男人是杀人犯	午夜列车	F
这个列车有规则限制乘坐人总年龄不能超过多少岁	午夜列车	F
婆婆是人	午夜列车	T
马上就要午夜12点了	午夜列车	T
那个婆婆是正常人	午夜列车	T
这个男人是列车工作人员	午夜列车	F
未来有事情发生	午夜列车	T
男子要找一个70岁的人	午夜列车	F
婆婆和男子认识	午夜列车	F
男子知道这些乘客的年龄是因为他认识他们	午夜列车	F
他都超能力和列车有关	午夜列车	F
他是警察	午夜列车	N
男子有特异功能	午夜列车	T
男子能看出谁到几岁死	午夜列车	T
婆婆是杀人犯	午夜列车	F
婆婆的年龄会导致一些事情发生	午夜列车	F
男子是要在午夜到来之时猜对所有人的年龄	午夜列车	F
这些人的年龄和自己的死有关	午夜列车	T
跟车上的人对话之后 男子知道自己在几岁死去	午夜列车	T
男子能看到每个人的年龄	午夜列车	F
婆婆是不是快去世了	午夜列车	T
男子可以看到别人的死期	午夜列车	T
男子害怕过生日	午夜列车	F
男人看到婆婆的年纪是70	午夜列车	F
70岁的人会对男子有危险	午夜列车	F
再过五分钟是婆婆生日	午夜列车	F
男子是因为老婆婆的话而脸色惨白	午夜列车	T
婆婆是午夜出生的	午夜列车	N
脸色惨白和该男子的年龄有关	午夜列车	F
婆婆是男子的亲人	午夜列车	F
婆婆可以预料到事故嘛	午夜列车	F
这个男子在找人	午夜列车	F
男子猜错了就会死	午夜列车	F
他要和年级最大的人交换身体	午夜列车	F
男子打算伤害婆婆	午夜列车	F
列车上的人都将会死掉	午夜列车	T
数字是死亡年龄	午夜列车	T
男子一直在循环	午夜列车	F
男子认识她们	午夜列车	N
男人是医生	午夜列车	F
列车会让人变老	午夜列车	F
这个男子是不是穿越了	午夜列车	F
列车会导致这些人死亡	午夜列车	T
他吓到是因为列车要出事了 他们都要死了	午夜列车	T
他以前坐过这辆列车	午夜列车	N
男子上错了车	午夜列车	N
婆婆70岁的时候男子会死掉	午夜列车	F
男人可以看见他人的寿命	午夜列车	T
他看见他们都带了身份证了	午夜列车	F
男子看到的不是年龄而是死亡年龄	午夜列车	T
男子在寻找一个通缉犯	午夜列车	F
婆婆也有超能力	午夜列车	N
他们都要死掉了男的能看到他们活了多久	午夜列车	T
男子有预知能力	午夜列车	T
车上的人相互认识	午夜列车	N
婆婆的死亡和男子有关	午夜列车	F
男的要死了	午夜列车	T
男子来自未来	午夜列车	N
这一列车的人全部都要死了	午夜列车	T
他有超能力知道人死亡的时间但不知道自己的问完婆婆时候他知道自己马上要死了	午夜列车	T
再过五分钟全列车的人都要因为列车事故而死	午夜列车	F
男子超能力	午夜列车	T
乘客马上都要死了	午夜列车	T
车上的乘客年龄超过七十岁会发生不好的事情	午夜列车	F
这俩列车是往生列车	午夜列车	F
男生有超能力能看到每个人年龄和她死亡时间而午夜死亡的人会变成厉鬼索命他知道老太太马上会变鬼杀了他	午夜列车	F
如果男子猜对年龄 列车就会出事	午夜列车	F
男的是通过什么物品得知的乘客年纪	午夜列车	F
男子要害人	午夜列车	F
车上几人有关系	午夜列车	N
我不敢去阳台是因为害怕	阳台上的女孩	T
女孩不是活人被我发现我不敢再去阳台看见她	阳台上的女孩	T
女孩已经死了他的鬼魂一直在对面吸引我去查看只要去了就会死	阳台上的女孩	F
我不敢是因为小女孩长相	阳台上的女孩	F
我们阳台很高有栅栏	阳台上的女孩	N
她吊死了	阳台上的女孩	T
对面楼废弃了	阳台上的女孩	F
女孩已经死了很一段时间了	阳台上的女孩	T
女孩早就死了尸体吊在阳台看起来像在打招呼	阳台上的女孩	T
故事里有尸体	阳台上的女孩	T
女孩真的是在打招呼	阳台上的女孩	F
故事里有第三个人	阳台上的女孩	F
女孩是疯子	阳台上的女孩	N
女孩跟我打招呼是我的错觉	阳台上的女孩	T
女孩是因为我而死的	阳台上的女孩	F
我还活着	阳台上的女孩	T
女孩从阳台跳下去了	阳台上的女孩	F
我发现女孩的打招呼是尸体在摇摆	阳台上的女孩	T
女孩出事了	阳台上的女孩	T
玻璃窗上有女孩呼出的雾气	阳台上的女孩	N
女孩是开心的跟我打招呼	阳台上的女孩	N
女孩有精神疾病	阳台上的女孩	F
女孩跟我打招呼的目的不纯	阳台上的女孩	N
打完招呼她就跳下去了	阳台上的女孩	F
女孩是真人	阳台上的女孩	F
女孩晚上也会和我打招呼	阳台上的女孩	N
阳台有死人	阳台上的女孩	T
现在和我打招呼的是女孩的鬼魂	阳台上的女孩	F
女孩是被对面的人杀死的	阳台上的女孩	F
女孩其实站在自己家阳台	阳台上的女孩	F
女孩是定时玩偶嘛	阳台上的女孩	F
女孩吊死三周了	阳台上的女孩	T
对面的阳台被拆了	阳台上的女孩	F
有人死了	阳台上的女孩	T
我知道女孩为什么死	阳台上的女孩	F
我有危险	阳台上的女孩	F
每天打招呼的时候已经死了	阳台上的女孩	T
阳台的女孩是已死亡状态	阳台上的女孩	T
女孩尸体被人发现了	阳台上的女孩	T
女孩身体有残缺	阳台上的女孩	F
其实女孩站的阳台是我家	阳台上的女孩	F
杀了女孩的人要来杀我了	阳台上的女孩	F
女孩每天复活	阳台上的女孩	F
女孩是在提醒我什么	阳台上的女孩	F
女孩是很孤独	阳台上的女孩	N
女孩和我长得一样	阳台上的女孩	N
女孩是老师	阳台上的女孩	N
女孩被监禁了想要找我求救	阳台上的女孩	F
我和女孩有恩怨	阳台上的女孩	F
我是不是一直被监视	阳台上的女孩	N
阳台有脏东西	阳台上的女孩	F
女孩不是活人	阳台上的女孩	T
对面楼死过人	阳台上的女孩	T
女孩是不是一直没有变换过姿势	阳台上的女孩	N
对面的女孩是尸体摆出打招呼的姿势	阳台上的女孩	N
女孩被做成了风铃	阳台上的女孩	F
女孩死了被人发现了	阳台上的女孩	T
女孩是不是挂在阳台上的	阳台上的女孩	T
每天少一个手指	阳台上的女孩	N
我目睹了一场凶杀案	阳台上的女孩	F
和我打招呼的是尸体	阳台上的女孩	T
这个女孩在阳台去世了	阳台上的女孩	T
那个女孩后面有个凶手	阳台上的女孩	F
女孩是一个被吊死的人	阳台上的女孩	T
女孩挥手是在求救	阳台上的女孩	F
女孩已经死了	阳台上的女孩	T
她家有阳台	阳台上的女孩	T
女孩已经死了我不敢踏进阳台	阳台上的女孩	T
女孩想杀我	阳台上的女孩	F
我做过一些对不起女孩的事	阳台上的女孩	F
女孩早没了	阳台上的女孩	T
女孩已经死了尸体被挂在阳台上	阳台上的女孩	T
我目睹了女孩被杀的过程	阳台上的女孩	F
她是被人摆成打招呼的姿势的	阳台上的女孩	N
看到的女孩是鬼	阳台上的女孩	F
我是因为害怕所以不敢去阳台	阳台上的女孩	T
女孩是尸体被人挂上去的嘛	阳台上的女孩	F
女孩吊死在那里 我以为是跟我打招呼	阳台上的女孩	T
是照片	阳台上的女孩	F
她家进去过其他人	阳台上的女孩	N
女孩已经上吊自杀了	阳台上的女孩	T
我害怕是因为我意识到女孩其实是尸体	阳台上的女孩	T
女孩不是在和我打招呼	阳台上的女孩	T
那个女孩当着我的面跳下去了	阳台上的女孩	F
阳台有动物	阳台上的女孩	N
女孩一直在偷窥监视我	阳台上的女孩	F
她被做成雕塑了	阳台上的女孩	N
女孩被监禁了	阳台上的女孩	F
是有人操控女孩每天打招呼	阳台上的女孩	F
我和她同居	阳台上的女孩	F
我喜欢女孩	阳台上的女孩	N
那个女孩是我前女友	阳台上的女孩	F
我杀了女孩	阳台上的女孩	F
对面楼根本没有阳台	阳台上的女孩	F
他以为女孩在打招呼其实对方早死了忽然发现他不敢去阳台	阳台上的女孩	T
女孩没有影子	阳台上的女孩	N
我怕被女孩杀了	阳台上的女孩	F
杀她的凶手来找我了	阳台上的女孩	F
我恐高	阳台上的女孩	N
死了的人喜欢女孩	阳台上的女孩	F
女孩被绑架了	阳台上的女孩	F
她喜欢我	阳台上的女孩	F
我看见有人把女孩搬走了	阳台上的女孩	F
我被谁威胁了	阳台上的女孩	F
我再进阳台会遇到危险	阳台上的女孩	F
她是尸体	阳台上的女孩	T
我杀死了女孩	阳台上的女孩	F
对面根本没人只是一面镜子	阳台上的女孩	F
是这个女孩导致我不敢再到阳台	阳台上的女孩	T
女孩是投影	阳台上的女孩	F
女孩掉下去了	阳台上的女孩	F
女孩是活着的	阳台上的女孩	F
女孩是我的追求者	阳台上的女孩	N
我踏入阳台会对我造成生命危险	阳台上的女孩	F
女孩是男扮女装	阳台上的女孩	F
女孩被人杀了做成木偶放到阳台	阳台上的女孩	F
对面的不是活的女孩	阳台上的女孩	T
男子真的是坠落死亡的	半根火柴	T
这是幻觉	半根火柴	F
男子坐飞机	半根火柴	F
男子是从热气球上自己跳下来的	半根火柴	F
从热气球上掉下来的	半根火柴	T
有人杀了男子	半根火柴	T
火柴是否被点燃过	半根火柴	F
点火柴是因为沙漠晚上太冷	半根火柴	F
是自然因素导致坠落	半根火柴	F
他是饿死的	半根火柴	F
男人被推下来摔死的	半根火柴	T
是太冷了燃烧火柴取暖	半根火柴	F
火柴吸引了野兽	半根火柴	F
热气球的氢气被点燃了	半根火柴	F
他死之前是不是在天上	半根火柴	T
他的同伴想通过火柴像别人传达一些信息	半根火柴	F
从骆驼上掉下来了	半根火柴	F
他冻死了	半根火柴	F
他死了不久	半根火柴	F
男人抽签抽到最短的一根火柴	半根火柴	T
抽到半根火柴的人被推下去	半根火柴	T
热气球是不是坠落了	半根火柴	F
热气球马上坠落了必须减重男子抽到了代表被丢出去的半根火柴	半根火柴	T
火柴烧断了降落伞	半根火柴	F
他是从飞机上摔下来的	半根火柴	F
男子乘坐的是热气球	半根火柴	T
男人真的死了	半根火柴	T
行李里是见不得人的东西	半根火柴	F
男子是失足坠落	半根火柴	F
热气球火被吹灭了	半根火柴	F
他抽烟	半根火柴	F
男人是抽签抽到半根火柴被扔下去的	半根火柴	T
沙漠里有楼么	半根火柴	F
男人死于抽签	半根火柴	T
男子坐的飞艇	半根火柴	F
男人的死跟火柴有没有关系	半根火柴	T
死者是踩空了	半根火柴	F
他是冻死的	半根火柴	F
男子烧断了热气球的绳子	半根火柴	F
是热气球意外爆炸	半根火柴	F
男子抽签抽中了半根火柴	半根火柴	T
他是想用火柴计算坠落时间	半根火柴	F
他是自然原因死亡的	半根火柴	F
这是灵异事件	半根火柴	F
男人有精神疾病	半根火柴	F
男子因为抽签到他了所以被推下来了	半根火柴	T
他有心理疾病	半根火柴	F
天太热了沙子融化了	半根火柴	F
他是从车上摔下来的	半根火柴	F
男人是瞎子	半根火柴	F
他想点燃火柴让救援能更好的寻找到自己	半根火柴	F
死亡的原因是因为热气球上很冷他用火柴取暖	半根火柴	F
他的火柴点着过	半根火柴	F
他是被吓到然后摔下来摔死的	半根火柴	F
他是从附近悬崖掉下来的	半根火柴	F
男子因为抽签失败了被推下来了	半根火柴	T
热气球没动力了	半根火柴	T
他是为了驱赶什么东西而点燃火柴的	半根火柴	F
被沙尘暴刮过来的	半根火柴	F
男子的半根火柴是关键	半根火柴	T
抽到半根火柴的会死	半根火柴	T
有别人和男子同行	半根火柴	T
火柴是男人自己的	半根火柴	N
男子点火柴是想取暖	半根火柴	F
点燃火柴煮饭	半根火柴	F
热气球超载	半根火柴	T
男子乘坐热气球时掉下来的	半根火柴	T
男子昏迷	半根火柴	F
他在飞机上点燃了火柴	半根火柴	F
男人是抽签死的	半根火柴	T
热气球还在飞	半根火柴	N
男子是点燃火柴产生了幻觉	半根火柴	F
一群人在热气球上面用火柴抽签 来决定谁跳下去	半根火柴	T
行李是满的	半根火柴	F
男子是意外死亡的	半根火柴	F
火柴其实是男人的手指头	半根火柴	F
他从热气球上摔下来	半根火柴	T
他坐热气球的时候把热气球点着了 坠落	半根火柴	F
他要抽烟	半根火柴	F
沙漠是不是发生过沙尘暴	半根火柴	F
男子抽签抽到了最短的火柴被扔下了热气球	半根火柴	T
男子生病了	半根火柴	F
他的同伴为了给热气球减轻重量	半根火柴	T
男子是从车上摔下来死的	半根火柴	F
他的死和爱情有关	半根火柴	F
男子是和行李一起坠落的	半根火柴	F
热气球出故障了	半根火柴	T
他们是开车过来的	半根火柴	F
男子在热气球上面抽烟	半根火柴	F
点火柴是为了取暖	半根火柴	F
他点火柴和热气球有关	半根火柴	T
热气球没火了摔死的	半根火柴	F
是行李箱把他砸死的	半根火柴	F
火柴是否因为高速摩擦被点燃	半根火柴	F
男子使用火柴是想求救	半根火柴	F
火柴灭了他看不清路所以坠落身亡	半根火柴	F
他是演员	半根火柴	F
他不小心烧了热气球	半根火柴	F
火柴是凶手点的	半根火柴	F
他想点热气球操作失误坠落死了	半根火柴	F
火柴抽签决定生死	半根火柴	T
男子是摔死的	半根火柴	T
因为运气不好所以他死了	半根火柴	T
半根火柴是用来照明的	半根火柴	F
男子被冻死了	半根火柴	F
火柴是照明用的	半根火柴	F
男子之前想要点烟	半根火柴	F
火柴是别人放上去的	半根火柴	F
男人是被拥有另外半根火柴的人谋害致死的	半根火柴	F
男子是从直升飞机上坠落的	半根火柴	F
男子是从悬崖上掉下来的	半根火柴	F
他的尸体附近有其他物品或痕迹表明他曾尝试生火	半根火柴	F
男人天黑没看到悬崖失足摔死	半根火柴	F
另外半根火柴因为坠落熄灭了	半根火柴	F
死者是自杀	半根火柴	F
他是点燃火柴产生幻觉后摔死的	半根火柴	F
男子是抽签后被扔下来的	半根火柴	T
行李跟死亡有关	半根火柴	T
他是因为在热气球上面抽签被人推下来的	半根火柴	T
死者从围墙上坠落的	半根火柴	F
周围有建筑物	半根火柴	F
火柴是为了点烟	半根火柴	F
火柴只有半根是因为燃烧了	半根火柴	F
男子从车上坠落	半根火柴	F
男子想要点燃热气球	半根火柴	F
是热气球没气了男子想用火柴代替	半根火柴	F
男子纵火	半根火柴	F
热气球炸了	半根火柴	F
他以為看到綠洲所以死的	半根火柴	F
男人精神有问题	半根火柴	F
男子掉下来的时候是晚上	半根火柴	F
火柴是否为他自己点燃的	半根火柴	F
男子迷路踩空了	半根火柴	F
男子是被冻死的	半根火柴	F
他是因为被困在沙漠里自杀的	半根火柴	F
男人死亡和半根火柴有关	半根火柴	T
他的尸体附近是不是有悬崖峭壁	半根火柴	F
男子的火柴是用来辨别方向的	半根火柴	F
男子耗尽了热气球的氧气	半根火柴	F
男子是从沙丘上坠落的	半根火柴	F
沙漠里有山	半根火柴	F
男子是抽签被扔下热气球的	半根火柴	T
行李里面装的火柴	半根火柴	F
男的是在沙漠中坠亡的	半根火柴	T
火柴有毒	半根火柴	F
男子坐的是飞机	半根火柴	F
沙漠里有动物	半根火柴	F
他在高处被绑起来过	半根火柴	F
火柴熄灭的原因是没有氧气	半根火柴	F
他用火柴为了抽烟	半根火柴	F
他们是乘坐的热气球	半根火柴	T
男人在到达沙漠之前就死了	半根火柴	F
火柴是引诱动物来吃他	半根火柴	F
火柴是別人放上去的嗎	半根火柴	F
谁抽到半根火柴谁就离开交通工具	半根火柴	T
热气球爆炸坠毁	半根火柴	F
死者是不是魔术师	半根火柴	F
他点燃火柴许愿	半根火柴	F
在飞机上抽到了半根火柴被推下来了	半根火柴	T
坠落前他点燃火柴了	半根火柴	F
火柴用来点烟的	半根火柴	F
沙漠是不是发生过龙卷风	半根火柴	F
是自杀	半根火柴	F
是因为他的火柴在沙漠里发生了化学反应	半根火柴	F
热气球漏气了	半根火柴	F
男子是渴死的	半根火柴	F
男子是被抛尸的	半根火柴	F
火柴是他自己点燃的	半根火柴	F
男子用火柴照明	半根火柴	F
火柴是计时用的	半根火柴	F
男人出轨了	半根火柴	F
行李被翻过	半根火柴	F
有人想烧掉尸体	半根火柴	F
死亡现场是伪造的	半根火柴	F
男子身上有打火机	半根火柴	F
他是单身	半根火柴	F
热气球超重了	半根火柴	F
火柴是否被箱子点燃	半根火柴	F
他的死是因为沙尘暴	半根火柴	F
男人是被杀死的	半根火柴	T
他被动物袭击了	半根火柴	F
他渴死的	半根火柴	F
男子来旅游许愿	半根火柴	F
他是不是和热气球有关	半根火柴	T
男子是抽签输了	半根火柴	T
是投票决定的	半根火柴	F
被人从飞机上丢下来了	半根火柴	F
男人从飞机上坠落	半根火柴	F
用火柴抽烟结果只有一半	半根火柴	F
火柴烧断了什么东西	半根火柴	F
他当时想点燃什么	半根火柴	F
他要点燃热气球	半根火柴	F
男子看见了海市蜃楼	半根火柴	F
天黑看不见路点燃火柴看清路况结果脚下是悬崖然后摔死了	半根火柴	F
男人的热气球遇险了	半根火柴	T
男子的火柴是为了照明	半根火柴	F
男人死了很久了	半根火柴	N
他学卖火柴的小女孩	半根火柴	F
他在等人救援	半根火柴	F
这具尸体是死后被移到这里的	半根火柴	F
火柴是男人自愿点的	半根火柴	F
他是不是被人推了	半根火柴	T
他死之前想抽根烟	半根火柴	F
火柴是抽签用的	半根火柴	T
是否从骆驼身上坠落	半根火柴	F
他们是不是进行过抽签	半根火柴	T
是因为火柴导致热气球损坏的	半根火柴	F
热气球必须要减少重量	半根火柴	T
男子被抢劫了	半根火柴	F
死者从火车上坠落的	半根火柴	F
男人是失足掉落悬崖	半根火柴	F
是因为用火柴抽签	半根火柴	T
男子是故意跳下的	半根火柴	F
半根的火柴是抽签用的	半根火柴	T
抽到半截火柴就要被扔下来	半根火柴	T
男子用火柴和人拔河结果因为惯性失足摔死	半根火柴	F
男子运气差	半根火柴	T
他点燃火柴 寻求帮助	半根火柴	F
男子是不小心掉下去的	半根火柴	F
男子是被人推下去的	半根火柴	T
男人划火柴是想点燃什么	半根火柴	F
男子离家出走	半根火柴	F
热气球负载太重他被人推下来了	半根火柴	T
过路的人放的火柴	半根火柴	F
热气球的火灭了他想要点燃	半根火柴	F
是不是因为点了火柴所以导致他死了	半根火柴	F
男人坐热气球旅行想吸烟结果火柴把热气球点着了热气球损坏男人因此被摔死	半根火柴	F
死者是从建筑物上坠落的	半根火柴	F
死者是被撞飞后坠落的	半根火柴	F
热气球无燃料了	半根火柴	T
男子是从热气球上坠落的	半根火柴	T
男人其实没死	半根火柴	F
男子是坠落死亡的	半根火柴	T
他是在热气球上点的火柴	半根火柴	F
半根火柴是因为男子坠落弄断的	半根火柴	F
因为沙尘暴	半根火柴	F
男子从骆驼背上掉下来	半根火柴	F
男人从热气球跳下来的	半根火柴	F
男子曾经乘坐飞行工具在沙漠上面	半根火柴	T
男子很绝望	半根火柴	T
男子是迷失在沙漠后选择自杀的	半根火柴	F
火柴是坠落悬崖时挣扎时抓到的	半根火柴	F
热气球出事了大家抽火柴决定谁跳下去	半根火柴	T
他在招魂	半根火柴	F
骆驼讨厌烟味把死者甩下来了	半根火柴	F
火柴是用来杀人的	半根火柴	F
男子是被乌鸦杀死的	半根火柴	F
火柴是凶手塞的	半根火柴	F
火柴是用来点燃热气球的	半根火柴	F
他是烧水死的	半根火柴	F
他点燃过火柴	半根火柴	F
火柴是否由他人点燃	半根火柴	F
他冷死了	半根火柴	F
火柴点燃了热气球	半根火柴	F
抽签抽到最短的火柴	半根火柴	T
同伴活着	半根火柴	F
火柴已经点燃过了	半根火柴	F
火柴本来是要烧毁东西的	半根火柴	F
半根火柴是凶手放在他手里的	半根火柴	F
火柴是路过的人的	半根火柴	F
乌鸦杀了他	半根火柴	F
是同行者把他推下来的	半根火柴	T
男子是坐热气球没燃料了用火柴当燃料坠落的	半根火柴	F
他点火柴是为了抽烟	半根火柴	F
火柴是用来看清东西的	半根火柴	F
男子是在沙漠里坠落死亡的	半根火柴	T
男子的热气球是失去方向了	半根火柴	F
火柴是男人行李里的	半根火柴	F
他是想点火	半根火柴	F
男子产生幻觉了	半根火柴	F
手里的火柴是抽签工具	半根火柴	T
火柴是真的火柴	半根火柴	T
热气球被火柴戳破了	半根火柴	F
他和别人结伴而行	半根火柴	T
他是迷路了	半根火柴	F
男人是gay	半根火柴	F
死者从楼上坠落的	半根火柴	F
他是跟别人打赌打输了抽到半根火柴所以才死掉的	半根火柴	T
男人在沙漠里迷路	半根火柴	F
男子是从高空坠落的	半根火柴	T
他要生火	半根火柴	F
他是缺水而死	半根火柴	F
他是杀人犯	半根火柴	F
他在沙漠中看见了海市蜃楼以为是平地实际上走到了很高的地方然后踏空坠落死了	半根火柴	F
是同伴把他行李放到热气球边上天太黑男子拿着火柴照明没看清摔下来的	半根火柴	F
男子曾乘交通工具	半根火柴	T
男子点燃了易燃气体	半根火柴	F
男子乘坐热气球给热气球补火时失败最终坠落死亡	半根火柴	F
这个男的是不是要抽烟	半根火柴	F
男子是被抛弃的人	半根火柴	T
男子是被人绑到空中然后用火柴烧断绳子坠落的	半根火柴	F
他想点燃什么	半根火柴	F
海市蜃楼	半根火柴	F
他点火柴是为了取暖	半根火柴	F
他是不是从飞机上面掉下来的	半根火柴	F
火柴导致了爆炸	半根火柴	F
是从飞机上掉下来的	半根火柴	F
火柴是许愿的	半根火柴	F
他在给别人点烟	半根火柴	F
火柴是死后被人放上去的	半根火柴	F
在晚上男人喝醉酒了想划火柴点亮结果火柴把热气球点燃了男人因此被摔死	半根火柴	F
男子之前被绑架	半根火柴	F
他点燃烟花把自己嘣下来的	半根火柴	F
这个男的是他杀	半根火柴	F
是龙卷风导致男子死亡	半根火柴	F
火柴抓阄从热气球上摔下来摔死了	半根火柴	T
男人梦游	半根火柴	F
他热死了	半根火柴	F
树上抽烟摔死的	半根火柴	F
他从热气球上摔下来的	半根火柴	T
从骆驼上坠落的	半根火柴	F
是天气导致了坠落	半根火柴	F
男人是被人杀的	半根火柴	T
男子是从飞机上坠落的	半根火柴	F
他把自己绑在爆竹上飞起来了	半根火柴	F
点着火柴跳下来的	半根火柴	F
他是不是遭遇了沙尘暴	半根火柴	F
男子之前在热气球上	半根火柴	T
他想用火柴点燃行李箱	半根火柴	F
行李被别人动过了	半根火柴	F
是不是出现了海市蜃楼	半根火柴	F
他是去沙漠玩的	半根火柴	T
男生被人杀了	半根火柴	T
火柴点燃了某物	半根火柴	F
男子是因为食物不够了被别人从热气球上扔下来了	半根火柴	F
被风刮下来的	半根火柴	F
他是因为晚上天黑看不清路所以从高处坠落的	半根火柴	F
男人有仇敌	半根火柴	F
男子抽中了跳热气球的签所以为了减重被其他人推下来	半根火柴	T
是因为超载必须跳下去一人	半根火柴	T
半根火柴是烧断的	半根火柴	F
点火柴是为了照明	半根火柴	F
热气球上掉下来的	半根火柴	T
走不出沙漠男子绝望了	半根火柴	F
他是因为失误死的	半根火柴	F
夜晚的时候男子点火柴照亮但是失足坠落	半根火柴	F
火柴燃烧过	半根火柴	F
男子抽到了半根火柴	半根火柴	T
热气球上有别人	半根火柴	T
男子是从悬崖坠落的	半根火柴	F
男子死的时候是在沙漠里	半根火柴	T
男子是假死	半根火柴	F
尸体是从其他地方运过来的	半根火柴	F
男子抽到了火柴后被扔下来	半根火柴	T
画中的男人是个真的男人	一幅画	T
男子是活的	一幅画	T
画是窗户	一幅画	T
画面变了	一幅画	T
男子昨天去世了	一幅画	F
画动了	一幅画	F
画预告了死亡	一幅画	F
画是真的画	一幅画	F
我走到哪画中的人都盯着我	一幅画	N
第二天画里的男子不见了	一幅画	T
画其实是窗户	一幅画	T
这幅画里的男子是被人关起来了	一幅画	F
画的材质很特殊	一幅画	F
画中的男子是真的画出来的	一幅画	F
画里的男人死了	一幅画	F
那是镜子	一幅画	F
我认识他	一幅画	F
这幅画里的人犯罪了	一幅画	F
画的位置不是画是窗	一幅画	T
那是一面单面镜	一幅画	F
画中的男子是尸骸	一幅画	F
这幅画是用人血画的	一幅画	F
故事的主人公见过画中的男子	一幅画	F
画中的男子变丑了	一幅画	F
我被画吸进去了	一幅画	F
第二天画里的男人消失了	一幅画	T
我头皮发麻是因为画中的人	一幅画	T
我感到害怕	一幅画	T
男子睁开眼了	一幅画	F
昨晚是有人在窗户外看我	一幅画	T
我的身份重要	一幅画	F
画中的男子消失了	一幅画	T
那是窗户	一幅画	T
有超自然力量或犯罪事件	一幅画	F
画中男人还活着	一幅画	T
那个男人是杀人犯	一幅画	F
画是玻璃材质的	一幅画	T
画里的男人我之前在别的地方见过他	一幅画	F
那幅画里有我	一幅画	F
画上有血	一幅画	F
我疯了	一幅画	F
是一个下雨天	一幅画	F
男人第二天不见了	一幅画	T
我期间在其他地方又见到了男子	一幅画	F
实际并不是人像画	一幅画	T
画被替换成了尸体	一幅画	F
男子是真人在偷窥我	一幅画	T
画里面的男子像个女人	一幅画	F
画是用血画的	一幅画	F
画里出现了新的东西	一幅画	F
其实是有人在看着我	一幅画	T
我第一次看这幅画的时候正在发病	一幅画	F
那幅画是窗户	一幅画	T
画中男人没有五官	一幅画	F
第二天男子还在那里	一幅画	F
画里的是遗像	一幅画	F
男子是我	一幅画	F
画的内容让我感到恐惧	一幅画	F
画中的男子是不是和我有关系	一幅画	F
这幅画是赝品	一幅画	F
我讨厌画上的人	一幅画	F
这幅画被掉包了吧	一幅画	F
画家是杀人犯	一幅画	F
画中的男子又变好看了	一幅画	F
画的人是真实存在的	一幅画	T
我就是画里的人	一幅画	F
我被偷窥了	一幅画	T
画里是一个人	一幅画	T
发生了凶杀案	一幅画	F
我被吓到了	一幅画	T
画中的男子转了个角度	一幅画	F
画里的东西是真的人脸	一幅画	T
男子是在偷窥	一幅画	T
画的内容是恐怖的	一幅画	F
那是一幅画	一幅画	F
画是油画	一幅画	F
画中男子已故	一幅画	F
画被毁了	一幅画	F
画中男子他好帅	一幅画	F
画里装了摄像头	一幅画	F
这其实不是画	一幅画	T
画的是凶案现场	一幅画	F
有人死了	一幅画	F
那是有人站在那里	一幅画	T
我是画画的人	一幅画	F
是抽象画	一幅画	F
他是我认识的人	一幅画	F
我第二天看到了画中的男子	一幅画	F
画中人第二天和前一天的样子不一样	一幅画	T
那个男人喝过海龟汤	一幅画	F
男人透过窗户看我	一幅画	T
画是正常的画	一幅画	F
画其实是一扇窗户	一幅画	T
画的材质重要	一幅画	T
画不是画是窗子	一幅画	T
画家自杀了	一幅画	F
画的位置很奇怪	一幅画	F
画是不是窗户	一幅画	T
画中人是画家的情人	一幅画	F
画里的人前后有变化	一幅画	T
画里其实是真人	一幅画	T
第一天看错了 其实男人很丑	一幅画	F
远看是男子近看是女装大佬	一幅画	F
他没有脸	一幅画	F
第二天见到那幅画之前发生了什么事	一幅画	F
画很贵	一幅画	F
画中人的样子改变了	一幅画	T
我见到了那个画里的人	一幅画	N
我在现实中见到了画中的男子	一幅画	N
我在画中	一幅画	F
幅画其实不是画是窗户是一个男子在窗外偷窥	一幅画	T
有人偷画	一幅画	F
画是凶手画的	一幅画	F
第二天画面变了	一幅画	T
画中的人物是真实存在的	一幅画	T
男人不在画上	一幅画	T
我的脸出现在画上了	一幅画	F
我之前见过这位男子	一幅画	F
这是镜子	一幅画	F
一次看和第二次看是同一个东西	一幅画	F
画有变化	一幅画	T
那是画	一幅画	F
画里的头发是真的	一幅画	T
第二天看到的画才是真的画，第一天晚上看到的画是一个人在那里	一幅画	F
人被杀了藏在画里	一幅画	F
画里的男人是被囚禁了	一幅画	F
画的内容从男子变成了我	一幅画	F
画里面是活人	一幅画	T
画里的人是真人	一幅画	T
画是水墨画	一幅画	F
画的内容有异常	一幅画	T
那幅画是人皮做得	一幅画	F
画中的男子还在	一幅画	F
那不是画框 那是窗户	一幅画	T
画中男人是是活人	一幅画	T
我看见的画没有变	一幅画	F
我头皮发麻是因为这幅画不对劲	一幅画	T
画是不存在的而是其他东西	一幅画	T
画中的人我认识	一幅画	F
画中的人跟自己很像	一幅画	F
有人看着他	一幅画	T
第二天画里的男人腐烂了	一幅画	F
画中的男子是杀人犯	一幅画	F
画是镜子我看见我	一幅画	F
有人伤亡	一幅画	F
我和画中人认识	一幅画	F
那不是画是窗户的框然后有个真人一直站在窗户那里看着我	一幅画	T
画里的人是窗子外面的人	一幅画	T
画里的男人是自己	一幅画	F
画是人皮做的	一幅画	F
昨晚画中是真人	一幅画	T
画中男人是我的亲人	一幅画	F
这是自画像	一幅画	F
男的不见了	一幅画	T
因为画里的男人没有头皮	一幅画	F
画里的男人其实是在看我的男人	一幅画	T
画是标本	一幅画	F
我有生命危险	一幅画	N
画其实是镜子	一幅画	F
男人是鬼	一幅画	F
画中人是假的	一幅画	F
画中画的自己	一幅画	F
画中的男子做了什么让人头皮发麻的事情	一幅画	T
画上男子的脸会动	一幅画	F
那幅画是照片	一幅画	F
画是镜子	一幅画	F
那幅画不是真的画	一幅画	T
画中男人是死去的男友	一幅画	F
画中的是我	一幅画	F
画自己动了	一幅画	F
我不会说话了	一幅画	F
第二天看到了自己	一幅画	F
这幅画画的是一个杀人事件	一幅画	F
画变了	一幅画	T
男子的脸消失了	一幅画	T
男子死了	一幅画	F
那幅画第二天变得和第一天不一样了	一幅画	T
第二天看到画的时候画和第一次看到的有变化	一幅画	T
有脚步声	一幅画	F
男子的眼睛不见了	一幅画	F
画中人的位置改变了	一幅画	T
画中的男子活着	一幅画	T
画框是一个窗户	一幅画	T
这个人进入隧道以为自己自己又失明了	隧道	T
这个人有幽闭恐惧	隧道	F
他太兴奋了	隧道	F
男人有超能力	隧道	F
这个人自杀是因为发现病没治好	隧道	T
因为他家人全死了	隧道	F
在火车上受了刺激	隧道	T
这个人不想回去了	隧道	F
他看见妻子偷情了	隧道	F
跳车原因和病有关	隧道	T
男人的病是真的全都好了	隧道	T
他拿错病例了	隧道	F
觉得治好没希望了就自杀了	隧道	T
以为自己没治好	隧道	T
他被恶魔附身了	隧道	F
这个人曾经是个盲人	隧道	T
男人以为自己失明了	隧道	T
他想救人結果自己不小心跳下车	隧道	F
病没完全好	隧道	F
他发现了杀人现场	隧道	F
病复发了	隧道	F
自杀的时候火车停了	隧道	N
隧道时通往死亡世界	隧道	F
隧道里看到了认识的人	隧道	F
他看到了医院	隧道	F
他是开车的人	隧道	F
他的病真的好了么	隧道	T
病好与自杀有关系	隧道	T
他被迫跳下火车	隧道	F
临镇的医生真的把他治好了	隧道	T
是否存在一种病必须要见光	隧道	F
得了癌症	隧道	F
他怕黑	隧道	F
男人患了癌症	隧道	F
他欠了一屁股债	隧道	F
是不是收到了威胁	隧道	F
这个人重见光明了	隧道	T
他眼睛是用别人眼睛治好的	隧道	F
他就是单纯想死	隧道	F
他在隧道里看到了尸体	隧道	F
绝症不能治了	隧道	F
他得了臆想症	隧道	F
他失明经过隧道时的黑暗让他以为自己再度失明	隧道	T
这个人有妻子	隧道	F
他看见自己去看病了	隧道	F
他是因为看到隧道发病了么	隧道	F
看病很贵	隧道	F
男子想完整的去死	隧道	F
他看到广告了	隧道	F
他是被人推下去的	隧道	F
这个人患有幽闭恐惧症	隧道	F
这个人有保险	隧道	F
他看到了什么不该看到的东西	隧道	F
他帕金森	隧道	F
他吃人了	隧道	F
病没好	隧道	F
见鬼了	隧道	F
这个人有债务	隧道	F
他不是第一次来隧道	隧道	F
这个人怕黑	隧道	F
他被别人或周围环境杀死了	隧道	F
隧道上写了什么字	隧道	F
是不是怕黑	隧道	F
发现了其他病	隧道	F
因为为了治病他花光了所有的钱和家产	隧道	F
跳车是因为绝望	隧道	T
医生说经过隧道跳下去才能康复	隧道	F
他是心理有病	隧道	F
是医生有问题	隧道	F
他的病是妄想症所以他妄想自己已經病好了	隧道	F
他以为到站了	隧道	F
病治好了脑子没治好	隧道	F
他又看到了以前的病人来治病	隧道	F
男子有精神病	隧道	F
病真的好了	隧道	T
跟眼睛有关系	隧道	T
他去看的是心理医生	隧道	F
盲人复明以为自己又瞎了	隧道	T
因为回来的路上火车出现了事故他跳车了	隧道	F
这个人是在火车运行中自杀的	隧道	T
他发现坐错车了	隧道	F
进入隧道时他以为自己又瞎了	隧道	T
他的病是有关精神的	隧道	F
他是为了骗保	隧道	F
见到了怪物	隧道	F
他得的是黑暗恐惧症	隧道	F
他以前来过隧道	隧道	N
他之前坐过火车	隧道	N
他是自愿的	隧道	T
隧道的黑暗让他认为他又看不见了	隧道	T
隧道有问题	隧道	F
车上有人要杀他	隧道	F
隧道里有声音吓到他了	隧道	F
他害怕隧道	隧道	F
这个人自杀是因为病没有好	隧道	F
钱被偷了	隧道	F
他是不是意识到有人要杀自己	隧道	F
因为火车没人开	隧道	F
他意识到自己并不是瞎子	隧道	F
病好前他就想自杀	隧道	F
这个人有超能力	隧道	F
因为他以为火车要爆炸了	隧道	F
他治疗失明	隧道	T
他发现自己不是盲人	隧道	F
一个人坐火车去邻镇看病看完之后病全好了其实病没有好	隧道	F
这个人以为自己的病没好	隧道	T
隧道太黑他以为自己瞎了	隧道	T
这个故事有超自然因素	隧道	F
其实没有隧道是这个人再一次看不见了	隧道	F
因为车上的人欺负了他	隧道	F
病治好了	隧道	T
他以前是盲人进隧道时他以为又看不见了	隧道	T
因为他得的是心病得知真相之后想不开	隧道	F
看的病跟眼睛有关	隧道	T
得了绝症	隧道	F
这个火车跟来的时候坐的车是同一辆	隧道	F
疾病带来的寿命减少是否提前结算了	隧道	F
因为火车上有人杀人	隧道	F
他杀过人	隧道	F
他去看的是身体上的病而不是心理疾病	隧道	T
这个人有心理疾病	隧道	F
他失业了	隧道	F
这个人看病是为了自杀	隧道	F
他考试不及格了	隧道	F
他是精神疾病	隧道	F
这是个恐怖故事	隧道	F
医生说他活不久了	隧道	F
他去临镇看眼睛	隧道	T
他看的是失忆症	隧道	F
是不是受到了惊吓	隧道	F
他的病和交通工具相关	隧道	F
他希望病好	隧道	T
他被乘客推下车	隧道	F
他是医生	隧道	F
他的病受不了黑暗	隧道	F
因为那个人之前失明了治好后第一次坐火车过隧道时以为自己又失明了所以自杀了	隧道	T
隧道口发生了爆炸	隧道	F
他得癌症了	隧道	F
这个人以前是盲人 后来治好了 在隧道里以为自己又复发了	隧道	T
男人的病并没有好	隧道	F
病其实没好	隧道	F
在隧道里发病了	隧道	F
他老婆跑了	隧道	F
因为他觉得生活没希望了	隧道	T
火车有问题	隧道	F
这个人的病还没有好	隧道	F
这个人是不是盲人以为自己又盲了	隧道	T
他的病是阿兹海默	隧道	F
那个人的病没有好	隧道	F
他的病并没好	隧道	F
隧道沒有盡頭所以他跳車	隧道	F
是因为进入隧道之后全黑了他以为自己又瞎了	隧道	T
隧道会让他再次得病	隧道	F
因为他花了很多钱治病过隧道被偷了所有的钱	隧道	F
他是治的眼睛	隧道	T
他得了盲病	隧道	T
他病治好的代价是不能去地下	隧道	F
隧道坍塌了	隧道	F
他看不见了听到声音就下车了	隧道	F
他本来是盲人看不到光治好后过隧道以为又看不到了很绝望	隧道	T
病好了但是没钱	隧道	F
他之前是盲人治好了进了隧道以为又盲了	隧道	T
自杀是因为觉得又瞎了	隧道	T
他自杀是因为钱	隧道	F
男人精神崩溃了	隧道	T
那人是去看眼睛的 经过隧道以为自己又看不见了	隧道	T
男人以为自己又瞎了	隧道	T
他之前眼盲过隧道以为自己又病了	隧道	T
火车会出意外	隧道	F
这个人治好的是眼病	隧道	T
他发现身边多了一个人	隧道	F
是不治之症	隧道	F
这个人失去了眼睛在火车经过隧道的时候以为天突然黑了吓得想要逃出火车随即摔死	隧道	F
隧道黑了以为瞎了	隧道	T
他眼睛有问题路过隧道以为自己病没治好又瞎了	隧道	T
他遇到了医生	隧道	F
他患的是视觉相关的病	隧道	T
男人能看到未来	隧道	F
进隧道很黑他以为他又病了	隧道	T
他眼睛有问题到隧道的时候看不见以为自己没有被治好	隧道	T
他原本的病是失忆症	隧道	F
他在隧道里杀人了	隧道	F
经过隧道时他感到不舒服	隧道	T
闺蜜和老公有一腿	闺蜜	T
问题在老婆身上	闺蜜	F
老婆和闺蜜是女同	闺蜜	F
托马斯做了错事	闺蜜	T
托马斯看老婆闺蜜的眼神不正常	闺蜜	F
老婆闺蜜是托马斯前任	闺蜜	N
托马斯之前就去过老婆闺蜜家	闺蜜	T
托马斯和老婆的闺蜜曾经有过联系	闺蜜	T
托马斯强奸过闺蜜	闺蜜	F
闺蜜和托马斯睡过	闺蜜	T
闺蜜和老婆关系好	闺蜜	F
托马斯之前去过闺蜜家	闺蜜	T
托马斯在闺蜜家认识了一个人	闺蜜	F
闺蜜变成他老婆了	闺蜜	F
托马斯喜欢老婆	闺蜜	N
托马斯老婆看到他手机里的聊天内容了	闺蜜	F
老婆是不是发现闺蜜和丈夫之前认识	闺蜜	T
离婚的原因是因为托马斯出轨	闺蜜	T
托马斯在他老婆闺蜜家里遇到了他老婆的前男友发现他们还保持着联系	闺蜜	F
托马斯骗老婆是第一次去	闺蜜	F
老婆是不是目睹了家暴现场	闺蜜	F
闺蜜是人贩子	闺蜜	F
男人自动连上了闺蜜家的wifi	闺蜜	T
他自动连上了闺蜜家的wifi	闺蜜	T
托马斯做错什么了	闺蜜	T
闺蜜结婚了	闺蜜	N
托马斯自己要回去 老婆不想回去	闺蜜	F
闺蜜家养宠物了	闺蜜	F
男人出轨闺蜜	闺蜜	T
托马斯认识闺蜜	闺蜜	T
老公的手机是不是直接连上她家网了	闺蜜	T
托马斯是暴露了某种习惯	闺蜜	T
闺蜜是小三	闺蜜	T
他骚扰闺蜜了	闺蜜	F
托马斯就是闺蜜	闺蜜	F
在闺蜜家看到了托马斯的物品	闺蜜	F
托马斯出轨了	闺蜜	T
托马斯偷看老婆闺蜜	闺蜜	N
她闺蜜死了	闺蜜	F
托马斯知道闺蜜家在几楼	闺蜜	T
觉得托马斯不如闺蜜老公	闺蜜	F
老婆出轨	闺蜜	F
是托马斯发现了老婆的秘密	闺蜜	F
托马斯的老婆在她闺蜜家里发现了托马斯之前与人的出轨证据	闺蜜	T
托马斯和闺蜜在一起了	闺蜜	T
闺蜜是老婆的亲人	闺蜜	F
托马斯在闺蜜家自动连上了WiFi	闺蜜	T
托马斯杀了她闺蜜	闺蜜	F
托马斯和闺蜜第一次见	闺蜜	F
托马斯的老婆是女同性恋	闺蜜	F
托马斯杀了人	闺蜜	F
回家路上发生的事导致离婚的	闺蜜	F
她的闺蜜说了老婆坏话	闺蜜	F
她和她闺蜜抓奸了托马斯	闺蜜	F
托马斯老婆认为托马斯不如闺蜜好	闺蜜	F
托马斯不是第一次去	闺蜜	T
他和她闺蜜睡觉了	闺蜜	T
连上wifi了	闺蜜	T
闺蜜暗恋老婆老婆其实也喜欢闺蜜	闺蜜	F
托马斯之前来过老婆闺蜜家	闺蜜	T
打架了	闺蜜	F
老婆出轨了闺蜜	闺蜜	F
离婚是老婆的问题	闺蜜	F
闺蜜有托马斯的孩子	闺蜜	F
男人和老婆的闺蜜搞在一起了	闺蜜	T
老婆是小三	闺蜜	F
他们要买房	闺蜜	F
托马斯对闺蜜家熟悉	闺蜜	T
托马斯有不好的念头	闺蜜	F
闺蜜喜欢托马斯	闺蜜	T
在闺蜜家发现老公的物品	闺蜜	F
老婆羡慕闺蜜	闺蜜	F
在闺蜜家吵架了	闺蜜	F
和出轨相关	闺蜜	T
闺蜜老公喜欢托马斯老婆	闺蜜	F
闺蜜怀孕了	闺蜜	F
老婆是在闺蜜家里发现了什么秘密	闺蜜	T
托马斯在闺蜜家里做了某些行为让他老婆觉得他很不尊重她	闺蜜	F
她闺密就住他家	闺蜜	F
老婆做了坏事	闺蜜	F
老婆看见了她的闺蜜手机上有老公托马斯传来的信息	闺蜜	F
跟电子设备有关	闺蜜	T
老婆看见了自己闺蜜和托马斯的合照	闺蜜	F
闺蜜和托马斯有矛盾	闺蜜	F
老婆谋害了闺蜜	闺蜜	F
托马斯手机里有闺蜜电话	闺蜜	N
她闺密喜欢托马斯	闺蜜	T
托马斯的东西是不是在闺蜜家	闺蜜	F
托马斯做了什么不好的事	闺蜜	T
闺蜜家很有钱 老婆很羡慕	闺蜜	F
他老婆发现了托马斯的什么秘密	闺蜜	T
她闺密不是人	闺蜜	F
托马斯之前见过老婆闺蜜	闺蜜	T
托马斯连了闺蜜的蓝牙	闺蜜	F
托马斯脾气暴躁	闺蜜	F
闺蜜了解托马斯的喜好	闺蜜	F
老婆死了	闺蜜	F
托马斯的老婆死了	闺蜜	F
闺蜜很好看	闺蜜	F
老婆和闺蜜在一起了	闺蜜	F
托马斯知道闺蜜住哪	闺蜜	T
离婚是闺蜜劝的	闺蜜	F
因为闺蜜家的狗认出来他了	闺蜜	F
闺蜜有老公	闺蜜	F
闺蜜喜欢老婆	闺蜜	F
老婆闺蜜是好人	闺蜜	F
老婆知道了托马斯的秘密	闺蜜	T
她的闺蜜和托马斯有私情	闺蜜	T
托马斯认识老婆的闺蜜	闺蜜	T
他老婆发现她老公的手机自动连上闺蜜家的wifi了	闺蜜	T
闺蜜做了坏事	闺蜜	T
老婆知道了一些什么事	闺蜜	T
托马斯的手机自动连接了wifi	闺蜜	T
闺蜜多嘴	闺蜜	F
老婆目睹老公出轨证据	闺蜜	T
托马斯把闺蜜杀了	闺蜜	F
闺蜜是托马斯前任	闺蜜	F
有人死了或者伤了	闺蜜	F
老婆认为他不忠	闺蜜	T
老婆发现闺蜜家有托马斯照片	闺蜜	F
发现和闺蜜有染	闺蜜	T
老婆看见了托马斯和他的闺蜜亲密	闺蜜	F
托马斯不喜欢女人	闺蜜	F
托马斯之前结过婚	闺蜜	F
托马斯的老婆在她闺蜜家里发现托马斯以前曾和闺蜜的男朋友或老公出轨过	闺蜜	F
托马斯不能吃辣	闺蜜	F
他老婆和托马斯是亲人	闺蜜	F
闺蜜家发生了一些让老婆不开心的事情	闺蜜	T
离婚是老婆提出来的	闺蜜	T
托马斯是直男	闺蜜	F
托马斯骚扰了闺蜜	闺蜜	F
闺蜜希望他们离婚	闺蜜	N
电子设备自动连上了闺蜜家的WiFi	闺蜜	T
托马斯对闺蜜不好	闺蜜	F
托马斯喜欢闺蜜的老公	闺蜜	F
托马斯对闺蜜做出了某些行为导致老婆认为托马斯出轨了	闺蜜	F
托马斯杀人了	闺蜜	F
托马斯出过轨	闺蜜	T
老婆跟托马斯离婚是因为闺蜜	闺蜜	T
他和她老婆的闺蜜有一腿被他老婆发现了	闺蜜	T
闺蜜是男的	闺蜜	F
他喜欢老婆的闺蜜	闺蜜	T
有人死了	闺蜜	F
闺蜜老公给闺蜜买东西了	闺蜜	F
闺蜜家与托马斯家有很大的区别	闺蜜	F
离婚是托马斯的问题	闺蜜	T
老婆闺蜜是同性恋	闺蜜	F
闺蜜讨厌托马斯	闺蜜	F
闺蜜死了	闺蜜	F
他老婆是不是女同	闺蜜	F
托马斯勾引闺蜜	闺蜜	F
老婆闺蜜有超能力	闺蜜	F
托马斯和闺蜜偷情	闺蜜	T
闺蜜漂亮	闺蜜	F
没有闺蜜这个人真实存在	闺蜜	F
老婆闺蜜爱上了托马斯	闺蜜	T
有人受伤害	闺蜜	T
妻子和闺蜜关系不好	闺蜜	F
她闺蜜和她说了什么	闺蜜	F
他没问密码 手机自动连上了闺蜜家的WiFi	闺蜜	T
托马斯是第一次见到闺蜜	闺蜜	F
托马斯和老婆关系不好	闺蜜	F
托马斯去过闺蜜家	闺蜜	T
托马斯和老婆闺蜜地下情	闺蜜	T
托马斯出轨对象在现场	闺蜜	T
托马斯在闺蜜家表现不好	闺蜜	F
丈夫和闺蜜发生了一些不好的事情	闺蜜	T
闺蜜和托马斯是好朋友	闺蜜	F
托马斯连上wifi了	闺蜜	T
托马斯会家暴	闺蜜	F
老婆不开心	闺蜜	T
他们三个互相之前都认识	闺蜜	T
托马斯一直盯着闺蜜看	闺蜜	F
托马斯有网恋	闺蜜	F
离婚是为了钱	闺蜜	F
托马斯的老婆的闺蜜的丈夫和托马斯认识	闺蜜	F
老婆是不是看见了凶杀现场	闺蜜	F
托马斯还爱他老婆	闺蜜	F
男人做了对不起老婆的事情	闺蜜	T
托马斯的妻子出轨了	闺蜜	F
闺蜜说了很多托马斯的坏话	闺蜜	F
她的闺蜜说了托马斯坏话	闺蜜	F
托马斯对老婆的闺蜜过于殷勤	闺蜜	F
闺蜜是男人	闺蜜	F
发现托马斯是杀人犯	闺蜜	F
老婆其实是同性恋	闺蜜	F
托马斯不是她老公	闺蜜	F
因为闺蜜喜欢托马斯想离间他们	闺蜜	F
老婆闺蜜暗示她跟丈夫离婚	闺蜜	F
老婆是不是发现了什么	闺蜜	T
是因为老婆在闺蜜家发现了什么东西	闺蜜	T
闺蜜和他认识	闺蜜	T
发现托马斯是女的	闺蜜	F
托马斯喜欢闺蜜	闺蜜	T
托马斯老婆喜欢上了闺蜜的丈夫	闺蜜	F
故事中有人犯罪	闺蜜	F
闺蜜劝离	闺蜜	F
托马斯要杀了他老婆	闺蜜	F
闺蜜是女同性恋	闺蜜	F
闺蜜说坏话了	闺蜜	F
托马斯第一次到闺蜜家但是手机却自动连上了wifi	闺蜜	T
闺蜜是好人	闺蜜	F
不存在闺蜜	闺蜜	F
老婆离婚是情感方面的原因	闺蜜	T
老婆发现丈夫出轨	闺蜜	T
是假离婚	闺蜜	F
闺蜜做了托马斯最爱吃的菜	闺蜜	F
是不是丈夫去闺蜜家可以直接用人脸识别打开门	闺蜜	F
托马斯和闺蜜是母子	闺蜜	F
闺蜜家有问题	闺蜜	F
他老婆发现了托马斯来过闺蜜家	闺蜜	T
她闺密是她妈妈	闺蜜	F
托马斯是在闺蜜家暴露了自己的秘密	闺蜜	T
托马斯想离婚	闺蜜	F
老婆闺蜜是托马斯的前女友	闺蜜	F
托马斯死了	闺蜜	F
闺蜜是单身	闺蜜	F
老婆想和闺蜜在一起	闺蜜	F
他对闺蜜家很熟悉	闺蜜	T
老婆喜欢上了闺蜜的男友或老公	闺蜜	F
托马斯和老婆闺蜜有关系	闺蜜	T
母亲在诅咒别人	仪式	F
妈妈开心	仪式	T
母亲挥舞手是发信号	仪式	F
父母出门后是去同一个地方	仪式	F
母亲是合唱团的指挥	仪式	F
他们偷偷在外面开房躲避我	仪式	F
父母要离婚了	仪式	F
母亲想杀人	仪式	F
母亲犯罪了	仪式	F
父母很缺钱	仪式	F
母亲转账是用于购买	仪式	T
我看见父母在喂猫	仪式	F
母亲要给父亲买礼物	仪式	F
妈妈是杀人犯	仪式	F
妈妈要杀了爸爸	仪式	F
妈妈喂猫	仪式	F
跟传销组织有关系	仪式	F
这个故事中有人恨着别人	仪式	F
母亲是杀人了么	仪式	F
有人死了	仪式	F
母亲转移财产	仪式	F
母亲参加邪教	仪式	F
母亲要买礼物	仪式	F
母亲吸毒	仪式	F
母亲在举行葬礼	仪式	F
母亲转账给很多人	仪式	N
母亲是在学手语	仪式	F
母亲买的东西很危险	仪式	F
老妈进传教组织了	仪式	F
妈妈把爸爸献祭了	仪式	F
母亲被威胁了	仪式	F
妈妈练习舞蹈	仪式	T
母亲出门是在尾随父亲	仪式	F
爸爸妈妈去约会了	仪式	F
晚饭是正常普通的晚饭	仪式	T
母亲有外遇	仪式	F
你母亲觉得你在帮你父亲解决什么问题偷偷跟出去发现你父亲就是去跳广场舞	仪式	F
母亲想送礼物	仪式	F
母亲挥舞双手是为了祈祷	仪式	F
我有问题	仪式	F
转账金额很大	仪式	F
母亲真的给别人转账了	仪式	T
母亲不是违法行为	仪式	T
我的母亲并不是什么邪教人员	仪式	T
母亲在杀人	仪式	F
母亲是要去买东西	仪式	F
母亲转走了父亲的钱	仪式	F
妈妈怀疑爸爸出轨	仪式	F
母亲的行为是为了父亲	仪式	F
晚饭里有东西	仪式	F
父亲出轨 母亲发现他给别人转账	仪式	F
母亲找法师施法	仪式	F
她给熟人转的账	仪式	F
母亲是想给谁惊喜	仪式	F
晚饭里有毒药	仪式	F
妈妈被催眠了	仪式	F
我在给父亲或者母亲转账	仪式	F
母亲是在直播	仪式	F
我生病了	仪式	F
母亲的行为与我有关	仪式	F
爸爸死了	仪式	F
妈妈是不是不会烧饭	仪式	F
我母亲挥舞双手是正常的	仪式	T
妈妈喜欢吵架	仪式	F
没有人死掉	仪式	T
父亲真的是出去散步么	仪式	T
是父亲有问题么	仪式	F
故事里有邪教因素	仪式	F
晚饭里有毒	仪式	F
妈妈在练习敲木鱼	仪式	F
妈妈在给别人打暗号	仪式	F
吵架是因为钱	仪式	F
父亲和母亲中有人出轨	仪式	F
母亲进行仪式是为了驱除邪魅	仪式	F
母亲想当厨师	仪式	F
母亲悄悄出门是去跟踪父亲	仪式	F
父亲死了	仪式	F
母亲用挥舞双手给别人打信号	仪式	F
妈妈是在跳广场舞嘛	仪式	T
父亲人格分裂	仪式	F
母亲转账是为了买东西	仪式	T
母亲信佛教	仪式	F
母亲转账是为了购买什么东西	仪式	T
母亲进行仪式是为了解决与父亲之间的问题	仪式	F
妈妈被鬼上身了	仪式	F
父亲出轨	仪式	F
母亲是把手机丢了	仪式	F
母亲举行仪式和吵架有关	仪式	F
挥舞双手是在跳广场舞	仪式	T
父亲是家暴	仪式	F
有人有特异功能么	仪式	F
故事是温馨的	仪式	T
父亲病了	仪式	F
妈妈要超度我	仪式	F
参加了什么宗教	仪式	F
父亲做了对不起我们母子俩的事情	仪式	F
他加入什么组织了	仪式	T
母亲准备杀害父亲	仪式	F
母亲给人转账了	仪式	T
母亲得病了	仪式	F
母亲在邪教里	仪式	F
母亲生病了	仪式	F
母亲转账给医生	仪式	F
妈妈在打苍蝇	仪式	F
我给主播转账了	仪式	F
转账是自愿的	仪式	T
母亲双手挥舞是为了招魂	仪式	F
母亲其实在招魂	仪式	F
母亲会手语	仪式	F
父母吵架是因为母亲的异常	仪式	N
她在跳广场舞	仪式	T
父亲失业了	仪式	F
母亲希望父亲死	仪式	F
父亲是和尚	仪式	F
母亲在减肥	仪式	F
是在学习跳舞	仪式	T
父亲参加邪教么	仪式	F
父母在演戏	仪式	F
我妈被骗了	仪式	F
母亲在驱赶什么东西	仪式	F
父亲嫖娼	仪式	F
母亲被鬼附身了	仪式	F
母亲是在给父亲准备惊喜	仪式	F
母亲是要学习跳舞	仪式	T
妈妈误入传销组织了	仪式	F
母亲是交警	仪式	F
父母是因仪式吵架的	仪式	F
母亲养了宠物	仪式	F
是不是在跳广场舞	仪式	T
母亲想要伤害别人	仪式	F
父亲是道士	仪式	F
母亲借钱了	仪式	F
我参加了母亲的仪式	仪式	F
转账是为了救人	仪式	F
母亲有杀心	仪式	F
父亲母亲之间有人生病了	仪式	F
父亲已经死了	仪式	F
母亲是为了给父亲买礼物	仪式	F
母亲要给爸爸惊喜	仪式	F
他们出去偷吃烧烤了	仪式	F
母亲很快乐	仪式	T
母亲信教了	仪式	F
母亲失忆了	仪式	F
母亲出门跳舞	仪式	T
转账是不是为了交学费	仪式	F
母亲有外遇了	仪式	F
爸爸生病了	仪式	F
母亲的行为是不违反道德的	仪式	T
母亲还活着	仪式	T
母亲死了	仪式	F
母亲想和父亲离婚提前转移财产	仪式	F
父母吵架的原因和我有关	仪式	F
父母吵架的原因与钱有关	仪式	F
母亲跟父亲去的是同一个地方	仪式	F
母亲是在学习什么东西	仪式	T
母亲是误入传销了	仪式	F
母亲是去找父亲	仪式	F
她想偷偷花钱	仪式	F
父亲有了私生子	仪式	F
母亲出门是参加活动	仪式	T
母亲找了私家侦探	仪式	F
母亲追星	仪式	F
他们有精神病	仪式	F
父亲有外遇	仪式	F
妈妈去跳舞了	仪式	T
母亲有精神类疾病	仪式	F
母亲是在从事迷信行为	仪式	F
老爸死了没	仪式	F
母亲是还魂师	仪式	F
母亲被人骗了	仪式	F
母亲有什么难言之隐	仪式	F
母亲涉及宗教	仪式	F
母亲加餐	仪式	F
母亲在练习指挥参加了合唱团	仪式	F
母亲是想自杀	仪式	F
仪式其实是为了家人而举行的	仪式	F
母亲被人控制了	仪式	F
母亲有宗教信仰	仪式	F
有人冒充我让母亲误以为我惹上麻烦了	仪式	F
他们进传销了	仪式	F
她在追剧	仪式	F
妈妈缺钱	仪式	F
母亲挥舞双手是自己的原因	仪式	T
母亲已经死了	仪式	F
父亲和母亲出门跳广场舞去了	仪式	F
挥舞双手是不是跳舞	仪式	T
母亲挥舞双手是在赶蚊子	仪式	F
母亲出轨	仪式	F
是邪教	仪式	F
妈妈有特异功能,能看见我们看不到的	仪式	F
母亲亲了父亲	仪式	F
妈妈有病	仪式	F
挥舞双手是在祈祷	仪式	F
母亲有疾病	仪式	F
母亲和父亲约会	仪式	F
是不是母亲私下学了舞蹈	仪式	T
母亲在保佑自己家庭	仪式	F
母亲家里藏了别人	仪式	F
父亲是有不忠	仪式	F
母亲要给父亲做法	仪式	F
母亲杀了父亲	仪式	F
母亲有愧于人	仪式	F
举行仪式是为了我	仪式	F
挥舞双手是为了驱赶什么东西	仪式	F
挥手是自愿的	仪式	T
父母吵架的原因是家里出现财务危机	仪式	F
母亲给认识的人转账	仪式	F
家里最近有人去世	仪式	F
母亲要学炒菜	仪式	F
母亲出去找父亲了	仪式	F
母亲是进了邪教	仪式	F
母亲其实是在帮我相亲	仪式	F
有人出轨	仪式	F
母亲在转账是和别人做交易	仪式	T
妈妈转账成功了	仪式	T
母亲想要驱魔	仪式	F
妈妈对人起了杀心	仪式	F
母亲在驱赶蚊子	仪式	F
母亲跟踪父亲	仪式	F
母亲挥舞手是无意识的	仪式	F
母亲想帮助父亲	仪式	F
母亲是去见活得生物	仪式	T
故事里有死人	仪式	F
父母感情不好	仪式	F
母亲信教	仪式	F
父亲知道母亲给别人转账么	仪式	F
母亲在抓奸	仪式	F
父亲是不是不同意母亲学舞蹈	仪式	F
母亲挥舞双手是因为信了邪教	仪式	F
父亲有小三么	仪式	F
母亲准备离家出走	仪式	F
吵架和我有关	仪式	F
妈妈转账是转移财产	仪式	F
故事涉及买凶杀人	仪式	F
母亲是在学指挥	仪式	F
妈妈不开心	仪式	N
母亲信仰佛教	仪式	F
电梯通向的楼层存在	电梯	T
我即将被困住	电梯	T
我忘记按电梯楼层了	电梯	T
今天是星期天	电梯	F
我按的是下降的	电梯	F
电梯失控	电梯	F
我死了就无法上学了	电梯	T
电梯是不是出故障往上升最后飞出楼房了	电梯	F
电梯下坠太快了我以为是上升	电梯	F
我住顶楼	电梯	F
我掉进电梯井了	电梯	F
我住在最高层	电梯	F
家里出事了	电梯	F
我按了电梯的楼层按钮	电梯	F
因为电梯坏了	电梯	F
电梯外有人死亡	电梯	T
电梯上升时我突然想起今天要去的地方改了地点	电梯	F
电梯在维修	电梯	F
我出事了	电梯	T
再也无法去学校的原因是要死了	电梯	T
电梯是真实存在的	电梯	T
电梯是出现了什么故障	电梯	F
电梯本该下降	电梯	T
电梯里有广告	电梯	F
有人贩子在楼上	电梯	F
电梯通往学校	电梯	F
我坐到了太平间	电梯	F
电梯到了楼顶	电梯	F
我会被杀害	电梯	T
我死亡是因为被电梯夹住了	电梯	F
我看见凶手了	电梯	T
我走错电梯了	电梯	F
按不到电梯按钮	电梯	F
我忘记按下1楼的按键	电梯	T
有坏人在楼上或楼顶	电梯	T
凶手发现我了然后把我给杀了	电梯	T
电梯缠住了我的书包带	电梯	F
电梯中只有我一个人	电梯	T
我有精神疾病	电梯	F
电梯的按钮是无限多的	电梯	F
我是不是做了什么不好的事情导致被学校退学	电梯	F
有杀人犯	电梯	T
电梯加速上升之后故障了 我被困在电梯里了	电梯	F
凶手从楼梯追我我坐电梯上去	电梯	F
是学校的原因导致我无法再去学校了	电梯	F
我不喜欢上学	电梯	F
是在电梯里上吊了	电梯	F
发现了杀人现场	电梯	T
电梯被人按了	电梯	T
我死于自杀	电梯	F
我被害了	电梯	T
是有人操控电梯让电梯上升	电梯	T
我是意外死亡	电梯	F
电梯上升到最顶楼	电梯	F
我被电梯卡到了然后被碾死了	电梯	F
无法去学校因为来不及要迟到了	电梯	F
我在重庆	电梯	F
我要去跳楼	电梯	F
学校发生意外了	电梯	F
电梯上升时门开着	电梯	F
电梯里有人想杀我	电梯	T
我要去的是太平间	电梯	F
在电梯里发现了一行字提醒我今天的谎言比昨天的大	电梯	F
我的死是由别人造成的	电梯	T
我被退学了	电梯	F
电梯突然停电了	电梯	F
我坐电梯到达了楼顶然后自杀了	电梯	F
我是不是被杀人犯看见了	电梯	T
电梯真的在上升	电梯	T
电梯上升把我甩飞了	电梯	F
电梯出了事故	电梯	F
我死亡是因为电梯里有其他人	电梯	T
我目睹了杀人现场	电梯	T
楼上的人是杀人犯	电梯	T
我被带到其他楼层	电梯	T
学校被炸了	电梯	F
是电梯故障	电梯	F
电梯门打不开	电梯	F
有人尾随我	电梯	F
我会被杀人犯杀死	电梯	T
我会死	电梯	T
在电梯合上的瞬间看到杀人犯了	电梯	T
我没按楼层	电梯	T
电梯是被楼上的人叫上去的	电梯	T
我被杀了	电梯	T
发生了火灾	电梯	F
我掉进梯井里了	电梯	F
死的人曾经求救	电梯	T
我最后被杀了	电梯	T
电梯被楼上的人按上了	电梯	T
电梯上升这一点很重要	电梯	T
学校在地下室	电梯	F
看到电梯里的谋杀	电梯	F
电梯上升被卡在电梯	电梯	F
电梯上升是我主动按的	电梯	F
电梯按钮坏了	电梯	F
有人在电梯里面	电梯	F
我已经毕业了不用去上学	电梯	F
我是被人故意杀害	电梯	T
我看到了一个人被杀了	电梯	T
电梯是否故障，本来应该下降	电梯	F
我看到了杀人	电梯	T
电梯下坠	电梯	F
这里面涉及灵异事件	电梯	F
我长大了不用上学了	电梯	F
我本来是要坐电梯下楼	电梯	T
电梯顶上有尸体	电梯	F
电梯失控上到顶楼了	电梯	F
有人要伤害我	电梯	T
电梯到了顶层还在上升	电梯	F
上升是有人摁了	电梯	F
电梯里有坏人	电梯	F
电梯进来别人了	电梯	T
电梯里有鬼	电梯	F
我有疾病	电梯	F
这是下雨天	电梯	F
突然一个乘电梯的人转过身来	电梯	F
有人死了	电梯	T
突然停电了	电梯	F
电梯外有可疑的人	电梯	T
电梯故障我即将摔死	电梯	F
凶手把电梯叫上去了	电梯	F
我被灭口了	电梯	T
电梯上去了我就被杀人犯杀死了	电梯	T
突然电梯急剧下降	电梯	F
电梯上升不符合按钮	电梯	F
我在电梯开门的时候看到了谋杀	电梯	T
电梯是通往天堂的	电梯	F
我本来应该是下楼	电梯	T
我会被凶手杀害	电梯	T
突然电梯的灯灭了	电梯	F
电梯是观光电梯电梯升高后他看见学校爆炸了	电梯	F
电梯坏了我被困在里面	电梯	F
电梯上升是因为坏了	电梯	F
我要去楼顶	电梯	F
我自杀了	电梯	F
电梯故障	电梯	F
有其他人	电梯	T
目睹了案发现场	电梯	T
电梯上不去一直在一层	电梯	F
有人在楼上按电梯	电梯	T
电梯上升特别快	电梯	F
我是要去顶楼	电梯	F
电梯里有人死了	电梯	F
我在电梯里上吊自杀了	电梯	F
我要去自杀	电梯	F
电梯往下走	电梯	F
一楼的按键坏了	电梯	F
我要死了	电梯	T
我死在电梯里了	电梯	F
我后来还活着	电梯	F
我还活着	电梯	F
我看到了死者	电梯	T
电梯里有高跟鞋女性	电梯	F
除了我还有其他人	电梯	T
别人不想让我去学校	电梯	T
去到了电梯原本没有的楼层	电梯	F
楼上有坏人	电梯	T
电梯上升的时候有人进来了	电梯	F
我杀人了	电梯	F
存在超能力	电梯	F
楼上有人杀人了	电梯	T
被杀人犯看到了我也死了	电梯	T
我不想去学校	电梯	F
我不能去学校是因为我已经死了	电梯	T
电梯上升的原因与人有关	电梯	T
我要跳楼	电梯	F
我是要到天台	电梯	F
我受伤害了	电梯	T
我是自己想去楼上的	电梯	F
我之前去过顶楼	电梯	F
我会被杀	电梯	T
电梯中除了我有别人	电梯	F
摁电梯的人被杀了	电梯	T
电梯上升时有人死了	电梯	T
是不是这是这个人的一场梦	电梯	F
我按的向下的按钮但是电梯向上走了	电梯	F
电梯爆炸了	电梯	F
这个故事里死的人数是一个以上	电梯	T
是我导致电梯上升的	电梯	F
我按错了电梯按钮却目睹了杀人现场	电梯	T
电梯里有杀人犯	电梯	F
这个电梯只有一层	电梯	F
我被人害了	电梯	T
我是老年人	电梯	F
电梯的目的地不是学校	电梯	T
故事中有第二个人	电梯	T
电梯去的不是我想到的终点	电梯	T
电梯到达我想去的楼层了	电梯	F
电梯之所以上升是因为女孩被杀害前为了求救按了电梯按钮	电梯	T
我不能去学校是因为我走进电梯之后我会迟到了	电梯	F
电梯上升是因为有被杀的人求救按下了电梯按钮	电梯	T
是不是出现电梯意外了	电梯	F
我去上学要下楼	电梯	T
是不是电梯外面有一个杀人犯	电梯	T
我在电梯里自杀了	电梯	F
楼上的人按了电梯	电梯	T
有人被杀	电梯	T
电梯正常运行的	电梯	T
我被分尸了	电梯	N
有人杀人了	电梯	T
电梯超载	电梯	F
电梯上升的速度是否不正常	电梯	F
电梯里有人被杀了	电梯	N
人是我爸爸杀的	小红裙	T
我如果不穿小红裙死者就能活下来	小红裙	T
死的人是意外死亡	小红裙	F
小红裙是这个尸体的么	小红裙	F
同学死了	小红裙	F
回错家了	小红裙	F
爸爸杀了人	小红裙	T
尸体是女的	小红裙	F
尸体是罪犯	小红裙	F
红裙是老师和妈妈约会的信号	小红裙	T
死者穿着小红裙	小红裙	F
姐姐杀了人脱下了小红裙给妹妹穿	小红裙	F
妈妈和老师有地下情	小红裙	T
妈妈和老师有一腿	小红裙	T
姐姐杀了一名小女孩将死者的红衣服给了我	小红裙	F
妈妈有外遇	小红裙	T
小红裙是直接死因	小红裙	T
我或姐姐杀人了	小红裙	F
死者不是家人	小红裙	T
尸体喜欢小红裙	小红裙	F
我如果今天不去上学尸体会出现	小红裙	F
小红裙是偷情暗号不小心穿上了结果被爸爸杀了	小红裙	T
死的人是我	小红裙	F
尸体也穿着小红裙	小红裙	F
姐姐是为了污蔑我妈	小红裙	F
裙子是霸凌的象征	小红裙	F
死的人想要性骚扰我	小红裙	F
这个小红裙原本是别人的	小红裙	F
我认识死的人	小红裙	T
尸体是在我穿上红裙后死的	小红裙	T
姐姐让我穿红裙是为了我能成为被杀目标	小红裙	F
尸体是小红裙的主人	小红裙	F
爸爸杀人了	小红裙	T
我认识死者	小红裙	T
尸体是洋娃娃	小红裙	F
死者是来找我玩的朋友或同学	小红裙	F
红裙是妈妈出轨的暗号	小红裙	T
姐姐死了	小红裙	F
被杀的是不是妈妈的情人	小红裙	T
我穿的真的是小红裙	小红裙	T
尸体是我的妈妈	小红裙	F
小红裙说明父亲不在家老师会来找母亲约会	小红裙	T
姐姐被校园霸凌	小红裙	F
死者是在我放学回来的时候死亡的	小红裙	F
凶手是随机杀人	小红裙	F
小红裙是暗号	小红裙	T
尸体是动物	小红裙	F
尸体是我的亲属	小红裙	F
我去代替姐姐上学	小红裙	F
我真的去上学了	小红裙	T
姐姐代替我死了	小红裙	F
尸体是我亲人	小红裙	F
凶手是我父亲	小红裙	T
尸体是真的死人	小红裙	T
父亲家暴性侵害	小红裙	F
这个尸体是我认识的人	小红裙	T
裙子是约会信号	小红裙	T
红裙子跟诅咒有关	小红裙	F
死的人是被人杀的	小红裙	T
尸体是我的家人	小红裙	F
尸体是人类尸体	小红裙	T
裙子的颜色重要	小红裙	T
死的人是男的	小红裙	T
我在学校杀人了	小红裙	F
爸爸杀了老师	小红裙	T
我杀人了	小红裙	F
这是姐姐的阴谋	小红裙	F
我穿的是人皮做的裙子	小红裙	F
是姐姐的尸体	小红裙	F
我并没有去上学	小红裙	F
有其他的人来我们家	小红裙	T
房间内是否有乐器	小红裙	F
红裙是求救信号	小红裙	F
凶手要杀的是我姐姐为了救我换了衣服所以被杀	小红裙	F
小红裙曾经是尸体穿过的	小红裙	F
是我的幻觉	小红裙	F
这个尸体伤害了姐姐	小红裙	F
爸爸杀了妈妈的情人	小红裙	T
是我的家人死了	小红裙	F
死的是穿小红裙的人	小红裙	F
小红裙是标志	小红裙	T
红裙子被死者穿过	小红裙	F
尸体是认识的人	小红裙	T
小红裙是寿衣	小红裙	F
毒死了	小红裙	F
真的死了人	小红裙	T
杀手本来要杀我	小红裙	F
姐姐回家了	小红裙	F
红裙的颜色是被血染红了	小红裙	F
尸体是我的爸爸	小红裙	F
尸体是爸爸	小红裙	F
上学不允许穿小红裙	小红裙	F
尸体是老师	小红裙	T
有人杀了双胞胎	小红裙	F
我是凶手	小红裙	F
是女孩的父母杀人了	小红裙	T
姐姐还活着	小红裙	T
我是因为换衣服发现尸体的	小红裙	F
姐姐的血染红了白裙子	小红裙	F
尸体是在学校死的	小红裙	F
那个人是自杀	小红裙	F
尸体是妈妈	小红裙	F
我的母亲和老师有染	小红裙	T
尸体是我杀的	小红裙	F
裙子是血染红的	小红裙	F
父亲不在家	小红裙	F
尸体是姐姐为保护我杀了的	小红裙	F
我穿红裙导致某人死了	小红裙	T
尸体是父母	小红裙	F
小红裙有什么含义	小红裙	T
尸体是我自己	小红裙	F
死者是小红裙原来的主人	小红裙	F
尸体我不认识	小红裙	F
我在上学的时候碰到了杀人犯	小红裙	F
姐姐上吊	小红裙	F
这个小红裙是姐姐的么	小红裙	F
死者是人	小红裙	T
小红裙是杀人的信号	小红裙	F
有人代替我死了	小红裙	F
我姐姐死了	小红裙	F
穿小红裙是为了保护我的安全	小红裙	F
爸爸杀的是妈妈的外遇对象	小红裙	T
尸体是被别人放进来的	小红裙	F
我穿红裙子代表爸爸不在家	小红裙	T
我杀了这个人么	小红裙	F
姐姐想要我死	小红裙	F
红裙是姐姐买的	小红裙	T
尸体是房东	小红裙	F
我穿的衣服是尸体的衣服	小红裙	F
杀手原本想杀的是我	小红裙	F
姐姐是故意让我穿红裙的	小红裙	F
死的是我	小红裙	F
姐姐为了买裙子杀人了	小红裙	F
父亲要杀掉没穿小红裙的	小红裙	F
是不是爸爸杀的	小红裙	T
老师死了	小红裙	T
尸体是一条鱼	小红裙	F
小红裙不是裙子	小红裙	F
我同学死了	小红裙	F
红白喜事我穿了小红裙家里有人去世了	小红裙	F
老师被别人杀了	小红裙	T
尸体是男人	小红裙	T
老师杀的人	小红裙	F
死者的死因和我有关	小红裙	T
尸体是老师的被父亲杀了	小红裙	T
小红裙是信号	小红裙	T
小红裙是姐姐的血染红的	小红裙	F
如果小女孩穿其他颜色的裙子会出现尸体	小红裙	F
有人要杀我姐姐保护我	小红裙	F
我妈出轨了	小红裙	T
红裙害死了那个人	小红裙	T
姐姐跟她男朋友争吵	小红裙	F
红裙子被杀手盯上了	小红裙	F
尸体是人的尸体	小红裙	T
裙子的颜色和死因有关系	小红裙	T
我穿红裙导致了他的死亡	小红裙	T
红裙是血染成的么	小红裙	F
父亲性侵姐姐了	小红裙	F
和色盲的原因有关	小红裙	F
尸体本应该是我	小红裙	F
我没有去上学	小红裙	F
尸体是我家人	小红裙	F
死的人是学校里的人	小红裙	T
姐姐去世了	小红裙	F
尸体是我的尸体	小红裙	F
尸体是被我家里人杀死的	小红裙	T
姐姐抢了死者的钱	小红裙	F
我有病	小红裙	F
尸体是另一位小孩	小红裙	F
这条小红裙是姐姐穿过的	小红裙	F
学校不让穿小红裙	小红裙	F
我在上学的路上看到了尸体	小红裙	F
姐姐卖淫	小红裙	F
我因为红裙躲过被杀	小红裙	F
爸妈死了	小红裙	F
我本来要死	小红裙	F
人是我家里人杀的	小红裙	T
妹妹死了	小红裙	F
尸体是我领居	小红裙	F
尸体只有晚上才出现	小红裙	F
尸体穿的红色衣服	小红裙	F
尸体的死亡和红衣服有关	小红裙	T
尸体是姐姐认识的人	小红裙	F
我去世了	小红裙	F
姐姐如果不送我小红裙尸体会出现	小红裙	F
尸体我们都不认识	小红裙	F
凶手是因为我去上学所以杀人的	小红裙	F
是不是穿了小红裙别人认为我是其他人	小红裙	F
红裙子是暗示某个人到家里来的信号	小红裙	T
红裙是姐姐自己做的	小红裙	F
死者是不是认识我妈	小红裙	T
父亲死了	小红裙	F
死的人自杀了	小红裙	F
我被错人认成了别人	小红裙	F
死的人是和我有关系的	小红裙	T
裙子是尸体的	小红裙	F
发现尸体跟穿红裙有关系	小红裙	T
姐姐是不是故意给我挑的红裙子	小红裙	F
死人与我穿小红裙有关	小红裙	T
我把姐姐杀死了裙子染上她的血	小红裙	F
红裙是为了保护我	小红裙	F
我被嫁祸杀人了	小红裙	F
有人跳楼	小红裙	F
家里发生了杀人案	小红裙	T
尸体是家里佣人	小红裙	F
穿红衣服和死亡有关系	小红裙	T
我如果不穿小红裙是不是不会有人死	小红裙	T
死者是我	小红裙	F
是我杀的	小红裙	F
我还活着	小红裙	T
裙子是血染的	小红裙	F
我很可能会遭遇不测	小红裙	F
妈妈死了	小红裙	F
尸体是陌生人	小红裙	F
是姐姐干的	小红裙	F
妈妈出轨了	小红裙	T
我走错家门了	小红裙	F
父亲是凶手	小红裙	T
死者与我家里人有仇	小红裙	F
死者是他杀	小红裙	T
死的人是被杀害的	小红裙	T
凶手原本要杀我	小红裙	F
是我杀的人	小红裙	F
死者的本意是要杀死我	小红裙	F
红裙是别人染血的皮肤做的	小红裙	F
尸体是邻居	小红裙	F
红裙有祭祀方面的意义	小红裙	F
尸体是我	小红裙	F
凶手是因为小红裙而行凶的	小红裙	F
小红裙上面是血迹	小红裙	F
尸体穿着小红裙	小红裙	F
男子是科学家	新闻	F
男子是缉毒警察	新闻	F
电视上是他自己	新闻	F
新闻里在说世界毁灭了	新闻	F
他觉得自己要失业了	新闻	F
男子在电视里看到自己了	新闻	F
他看到了他自己	新闻	F
男子是狱警	新闻	F
新闻报道男子死亡了	新闻	F
他看到了尸体	新闻	T
看到自己似乎目睹了杀人	新闻	F
男子被吓晕因为新闻的内容	新闻	T
男子有疾病	新闻	F
他出现在新闻里了	新闻	F
是他自己死亡了	新闻	F
他在新闻上看见了受害者的照片	新闻	T
男子是犯罪分子	新闻	F
工作的地方发生了事故	新闻	T
他见到自己在电视上	新闻	F
他遇到杀人犯了	新闻	F
新闻说他家有杀人犯	新闻	F
新闻内容播报的人是该男子	新闻	F
整个故事是否有人死	新闻	T
男子在工地工作	新闻	F
发现新闻说有杀人狂	新闻	F
看到交通事故了	新闻	F
男子工作中被拍到浏览黄色网站	新闻	F
新闻里报道入室抢劫	新闻	F
有男子见过的人出现在新闻里了	新闻	T
男子就是新闻的主播	新闻	F
男子遇到了尸体	新闻	T
男子的朋友或者同事出事情了	新闻	F
看的是亲人去世新闻	新闻	F
这个男人是不是买了A股	新闻	F
他害怕新闻里出现的人	新闻	F
男子的工作涉及黄赌毒	新闻	F
男子的身份被揭露了	新闻	F
新闻里报道的人物在他家里	新闻	F
男子在新闻里看到了自己	新闻	F
男子发现自己被开除了	新闻	F
新闻里说他的公司要倒闭了	新闻	F
他在新闻里见到了见过的人	新闻	T
新闻说他已经出事死亡了	新闻	F
新闻报道说这个男人失踪了	新闻	F
新闻是有关谋杀的	新闻	F
男子是在鬼屋工作	新闻	T
他的家人上新闻了	新闻	F
男子炒股炒失败了	新闻	F
这个男子成为了通缉犯	新闻	F
男子在殡仪馆工作	新闻	F
男子从事和建筑有关的工作	新闻	F
看到杀人犯了	新闻	F
男子是公务员	新闻	F
男子杀的人复活了	新闻	F
新闻中的事件和男子有关系	新闻	T
新闻内容和男子的工作地点有关	新闻	T
有杀人犯在男子家里	新闻	F
男子有生命危险	新闻	F
男子是程序员	新闻	F
男子死了	新闻	F
是这个新颁布的政策让他害怕	新闻	F
新闻在播报这名男子的死亡消息	新闻	F
男子曾经在鬼屋看见过电视上的人	新闻	T
有公布失踪者照片	新闻	T
男子的工作地点在网吧	新闻	F
男子是金融从业人员	新闻	F
新闻上的主持人其实已经死了	新闻	F
男子工作合法	新闻	T
男子是间谍	新闻	F
他见到总统被刺杀了	新闻	F
男子提前回家了	新闻	F
男子是逃犯	新闻	F
死的人是男子自己	新闻	F
男子是数据相关人员	新闻	F
男子在医院工作	新闻	F
电视提到延迟退休	新闻	F
他看到了杀人犯	新闻	F
新闻的内容有男子见过的人	新闻	T
男子是摄影师	新闻	F
他买的股票跌了	新闻	F
新闻提到了他公司	新闻	F
男子是情报人员	新闻	F
他单身	新闻	F
男子所干的工作是不合法的	新闻	F
男子工作的地方出事了	新闻	T
新闻内容是有杀人犯	新闻	F
男子无意泄露了政府的数据	新闻	F
新闻内容是关于杀人犯的	新闻	F
他看到了死去的人	新闻	T
他看到自己的通缉令了	新闻	F
男子听不到电视声音	新闻	F
男子是一个黑客	新闻	F
男人是因为那条新闻被吓晕的	新闻	T
新闻在播报死亡消息	新闻	F
男子是警察	新闻	F
公司倒闭了	新闻	F
电视里在播报杀人案	新闻	F
电视坏了	新闻	F
看到自己被裁员了	新闻	F
男子在火葬场工作	新闻	F
新闻内容是男子杀了人	新闻	F
他看到新闻内容是自己死了	新闻	F
新闻报导男子工作的地方出事了	新闻	F
公司认识的人杀人了	新闻	F
新闻里播报男子杀了人	新闻	F
同事是杀人犯	新闻	F
男子从事的工作不合法	新闻	F
新闻里显示了他家里有杀人犯	新闻	F
新闻说的是这个男子被尾随了	新闻	F
男子之前坐的交通工具车祸了	新闻	F
男子是小说家	新闻	F
新闻里报道的是杀人案	新闻	F
他结婚了	新闻	F
新闻内容是通缉男子	新闻	F
上班的时候看到了奇怪的东西	新闻	T
男子杀过人	新闻	F
新闻上看到了死亡的人的照片	新闻	T
新闻说他下班路上差点遭遇事故死亡	新闻	F
男子是医生	新闻	F
男子是黑社会的	新闻	F
男子将死去	新闻	F
新闻里有杀人犯	新闻	F
男子遇到了杀人犯	新闻	F
他在鬼屋工作，道具尸体是真的死了	新闻	T
他今天见到了电视里的死者	新闻	T
新闻报道鬼屋	新闻	F
有人死了	新闻	T
男子是军人	新闻	F
男子还活着	新闻	T
新闻里是他的家人	新闻	F
新闻里有恐怖的画面	新闻	F
和男子的家里有关	新闻	F
洗衣机的主人想把洗衣机带走	洗衣机	F
有人在操作洗衣机	洗衣机	T
有人出于某种目的启动洗衣机	洗衣机	T
拾荒者杀人了	洗衣机	F
洗衣机里面有衣服	洗衣机	F
他在洗衣机里睡	洗衣机	F
洗衣机里有血迹	洗衣机	T
发出来的声音不是真正洗衣机的声音	洗衣机	F
死者是洗衣机的主人	洗衣机	F
流浪汉被跟踪了	洗衣机	T
洗衣机里躲着一只流浪猫	洗衣机	F
有人按下了洗衣机	洗衣机	T
杀人犯启动了洗衣机	洗衣机	T
洗衣机其实是绞肉机	洗衣机	F
凶手是拾荒者	洗衣机	F
拾荒者认识启动洗衣机的人	洗衣机	F
凶手启动的	洗衣机	T
洗衣机启动导致了人的死亡	洗衣机	F
凶手在洗掉血迹	洗衣机	T
洗衣机启动的声音是杀人的声音	洗衣机	F
是拾荒者开的洗衣机	洗衣机	F
凶手半夜去他家启动洗衣机为了毁灭证据	洗衣机	T
洗衣机有自动启动程序	洗衣机	F
启动洗衣机的人是杀人犯	洗衣机	T
洗衣机是不是被定时启动了	洗衣机	F
洗衣机里有猫	洗衣机	F
启动洗衣机是在洗衣服	洗衣机	F
凶手启动洗衣机是为了抽水	洗衣机	F
洗衣机是拾荒者自己打开的	洗衣机	F
死者启动了洗衣机	洗衣机	F
启动洗衣机是为了掩盖杀人真相	洗衣机	T
是杀人犯启动了洗衣机	洗衣机	T
老鼠爬进去了	洗衣机	F
洗衣机是人为启动的	洗衣机	T
有第二个人在场	洗衣机	T
洗衣机里有死人	洗衣机	F
洗衣机有bug会自己启动	洗衣机	F
洗衣机定时启动	洗衣机	F
洗衣粉开启是为了洗衣服	洗衣机	F
杀人犯想清除他杀人的证据	洗衣机	T
有人死了	洗衣机	T
有人想帮助拾荒者	洗衣机	F
有人偷用他的洗衣机	洗衣机	T
洗衣机是死人启动的	洗衣机	F
拾荒者梦游	洗衣机	F
拾荒者捡到洗衣机的时候洗衣机里面有杀人犯	洗衣机	F
洗衣机里的人在动	洗衣机	F
洗衣机里有钱	洗衣机	F
犯人想嫁祸流浪汉	洗衣机	F
洗衣机里有衣服	洗衣机	F
洗衣机里面有杀人证据	洗衣机	T
有其他人用了他的洗衣机	洗衣机	T
死亡是意外	洗衣机	F
拾荒者以外的人启动了洗衣机	洗衣机	T
洗衣机是为了遮住开枪的声音的	洗衣机	F
他杀了洗衣机的主人	洗衣机	F
这个声音真的是洗衣机发出来的	洗衣机	T
他听到的是洗衣机启动的声音	洗衣机	T
洗衣机用来清洗血渍的	洗衣机	T
启动洗衣机的人死了	洗衣机	F
拾荒者被关进洗衣机	洗衣机	F
操作洗衣机的不是人	洗衣机	F
洗衣机的主人想拿回洗衣机	洗衣机	F
拾荒者幻听	洗衣机	F
除了拾荒者还有别人	洗衣机	T
洗衣机是处理尸体用的	洗衣机	T
洗衣机里面是不是空的	洗衣机	F
有人想嫁祸给拾荒者	洗衣机	F
其他人启动了洗衣机	洗衣机	T
拾荒者是否梦游	洗衣机	F
洗衣机漏电	洗衣机	F
他捡洗衣机被人发现了	洗衣机	T
洗衣机是用来洗掉犯罪证据的么	洗衣机	T
死的人是拾荒者	洗衣机	F
凶手杀人分尸 跟着拾荒者回家 想清理现场	洗衣机	T
洗衣机里的是活人	洗衣机	F
拾荒者是睡在自己家	洗衣机	T
开洗衣机的人想帮拾荒者洗衣服	洗衣机	F
洗衣机里面有证物	洗衣机	T
洗衣机上面有台收音机	洗衣机	F
是拾荒者启动了洗衣机	洗衣机	F
洗衣机里面是有活的东西	洗衣机	F
洗衣机被偷了	洗衣机	F
拾荒者设置了洗衣机定时启动	洗衣机	F
洗衣机启动的声音其实是什么东西走路的声音是	洗衣机	F
有人开洗衣机	洗衣机	T
洗衣机的主人想伤害他	洗衣机	F
洗衣机中有人	洗衣机	F
是跟着他回来的那个人启动的洗衣机	洗衣机	T
有人企图拿走洗衣机	洗衣机	F
杀人凶手跟踪来清理的	洗衣机	T
他睡在别人的家里了	洗衣机	F
洗衣机启动会导致有人去世	洗衣机	F
故事里有第二个人	洗衣机	T
拾荒者是精神分裂症	洗衣机	F
家里还有其他人	洗衣机	T
洗衣机里有老鼠	洗衣机	F
洗衣机里面有东西	洗衣机	T
杀人犯想吓跑流浪汉	洗衣机	F
洗衣机里洗的是他的衣服	洗衣机	F
启动洗衣机的人是他的家人	洗衣机	F
是有陌生人进了拾荒者家	洗衣机	T
洗衣机是人启动的	洗衣机	T
洗衣机被家里进来的陌生人无意碰到启动了	洗衣机	F
启动的洗衣机是用来洗衣服的	洗衣机	F
他自己启动的洗衣机	洗衣机	F
有人杀了人之后把尸体藏在洗衣机里了	洗衣机	T
拾荒者躺在洗衣机里	洗衣机	F
拾荒者是不是杀人了	洗衣机	F
他家在河边	洗衣机	F
流浪汉被杀了	洗衣机	F
启动洗衣机的人对拾荒者图谋不轨	洗衣机	F
他在自己的家里	洗衣机	T
它是一个自动定时启动的	洗衣机	F
有人闯入他的房子	洗衣机	T
有人进了拾荒者家	洗衣机	T
洗衣机里面的人活着	洗衣机	F
有人藏在洗衣机里被拾荒者带回家了	洗衣机	F
洗衣机里面不是衣服	洗衣机	T
洗衣机里边有人拾荒者听到了他挣扎的声音	洗衣机	F
洗衣机是可以远程控制的	洗衣机	F
有人想用洗衣机清洗血迹	洗衣机	T
有人是来偷东西的	洗衣机	F
那不是洗衣机的声音	洗衣机	F
洗衣机里的人想要爬出来	洗衣机	F
洗衣机里只有衣服	洗衣机	F
手机是在家里被找到的	丢失的手机	T
手机拍到了别人的罪证	丢失的手机	F
手机摔碎了	丢失的手机	F
我的手机被除我之外的人或物打开了	丢失的手机	T
手机一直在家	丢失的手机	T
手机出现在家里	丢失的手机	T
我手机在家里	丢失的手机	T
手机上有让人惊悚的内容	丢失的手机	F
手机去了很远的地方	丢失的手机	F
手机里有新的照片	丢失的手机	F
我最後有找到手机嗎	丢失的手机	T
手机拍到了东西	丢失的手机	F
手机丢失的时候有人打开过我的手机	丢失的手机	T
手机照到了一些照片	丢失的手机	F
我在不可能的地方找到了手机	丢失的手机	F
我在没接触过的地方找到的手机	丢失的手机	F
手机在家里	丢失的手机	T
手机是在家外面被找到的	丢失的手机	F
手机关机了	丢失的手机	F
手机上粘有血迹	丢失的手机	F
我在家	丢失的手机	F
找手机的过程中目睹杀人	丢失的手机	F
我今天没带手机出门	丢失的手机	T
我在哪丢的手机很重要	丢失的手机	T
我的房间里有别人	丢失的手机	T
有曾经逝世的熟人打来了电话	丢失的手机	F
手机没带出门	丢失的手机	T
手机里有杀人犯照片	丢失的手机	F
我给自己的手机打过电话	丢失的手机	T
有人在我家	丢失的手机	T
家里有人	丢失的手机	T
手机是我找到的	丢失的手机	T
我吃惊是因为手机的外表	丢失的手机	F
手机有故障	丢失的手机	F
手机出现在了不该出现的位置	丢失的手机	T
手机出现在我不可能去的地方	丢失的手机	F
手机换样子了	丢失的手机	F
我的手机在别人手上	丢失的手机	T
手机出现在案发现场	丢失的手机	F
是手机里面的东西吓我一跳	丢失的手机	F
打电话找手机别人接的电话	丢失的手机	T
我的手机一直在我手上	丢失的手机	F
在垃圾桶里找到的手机	丢失的手机	F
手机里有别人的照片	丢失的手机	F
我看见了什么不好的东西	丢失的手机	F
陌生人在家	丢失的手机	T
手机在家里找到	丢失的手机	T
我根本就没把手机带出门	丢失的手机	T
文中出现死人了	丢失的手机	F
手机被黑客入侵	丢失的手机	F
我没带手机出门给手机打电话有人接回家后发现手机在家里	丢失的手机	T
手机最终在我自己家里找到	丢失的手机	T
有人死了	丢失的手机	F
电话遗落在家里了但是我是独居	丢失的手机	T
手机坏了	丢失的手机	F
手機在床頭嗎	丢失的手机	T
看到手机里的照片	丢失的手机	F
房间里还有其他人	丢失的手机	T
手机在丢了之后记录了一些东西	丢失的手机	F
我的手机在户外	丢失的手机	F
有恐怖的短信	丢失的手机	F
吓一跳是因为手机变了	丢失的手机	F
我给我的手机打了电话	丢失的手机	T
手机被人用过	丢失的手机	T
我吓了一跳的原因是找到的地方让我吃惊么	丢失的手机	T
有人进来家里了	丢失的手机	T
手机是不是一直在我身上	丢失的手机	F
我的手机出现在了别人手里	丢失的手机	T
手机在原地但是被用过	丢失的手机	T
是发现手机的地方不对劲	丢失的手机	T
有男人接电话了	丢失的手机	T
我有精神病	丢失的手机	F
手机在床底	丢失的手机	F
手机打过电话	丢失的手机	T
我杀人了	丢失的手机	F
手机的壁纸之类的东西被篡改了	丢失的手机	F
我在家里找到手机发现手机被其他人用过说明我家有其他人来	丢失的手机	T
手机是否损坏	丢失的手机	F
我家里有别人	丢失的手机	T
手机自动拍照了	丢失的手机	F
手機放在我家裡	丢失的手机	T
手机是我在家找到的	丢失的手机	T
家里进了陌生人	丢失的手机	T
手机掉在地上	丢失的手机	F
手机是否在家里	丢失的手机	T
手机找到了但不是我的	丢失的手机	F
手机在别人家里	丢失的手机	F
手机屏幕上面有东西	丢失的手机	F
我是在家里找到的手机	丢失的手机	T
我真的找到我的手机了	丢失的手机	T
找手机的过程中被杀人犯看到了	丢失的手机	F
我通过手机屏幕发现我后面有个人	丢失的手机	F
手机是不是丢在没去过的地方	丢失的手机	F
手机有偷拍照	丢失的手机	F
我吓了一跳是因为手机上多了什么东西	丢失的手机	F
男友父母在女孩小的时候就见过她	见家长	T
父母还活着	见家长	T
阻止结婚是因为脸	见家长	F
我是他们的女儿	见家长	T
他父母防止近亲结婚	见家长	T
你脸上有东西	见家长	F
我和男朋友父母其实是没见过面的亲戚 但他父母见过我的照片	见家长	N
我是他父母抛弃的孩子	见家长	F
你和男友的父母有亲缘关系	见家长	T
我男友有前任	见家长	N
他们见过我的脸	见家长	T
父母大惊失色是因为我是他们的孩子	见家长	F
我后面是被养父母抚养长大的	见家长	T
因为一些原因我和男友不得不在两个家庭生活	见家长	T
女孩属于人类	见家长	T
我是男的	见家长	F
你和男友是近亲	见家长	T
女友其实是租过来的	见家长	F
你是杀人犯	见家长	F
女人长得和儿子一样	见家长	F
跟我的家庭背景有关	见家长	T
他们两个是兄妹	见家长	T
我是男友的家人	见家长	T
女孩是长得和男友父母的仇人一样	见家长	F
父母看到了我身旁或身后的什么东西才会大惊失色	见家长	F
父母大惊失色是因为的脸本身	见家长	F
女孩是男友父母的孩子	见家长	F
我的脸有什么怪异的地方	见家长	F
我是小学生	见家长	F
男友父母知道女孩身份	见家长	T
我父母和男友父母认识	见家长	T
男子的父母不正常	见家长	F
你脸有残疾	见家长	F
因为是鬼	见家长	F
我长得像他父母的旧情人	见家长	F
男友是亲哥	见家长	T
因为我是男的	见家长	F
我太老了	见家长	F
你是男友父母的亲生女儿	见家长	F
女主和男友有血缘关系	见家长	T
他们发现女生和男生长得很像	见家长	N
男子不正常	见家长	F
这个女生没有脸	见家长	F
他父母认识我父母	见家长	T
男友家里还有别人	见家长	N
男友和我是一家人	见家长	T
招赘婿	见家长	F
和他们女儿长得一样	见家长	F
女生脸和男方某个死去的家人很像	见家长	F
我很有名	见家长	F
我未成年	见家长	F
男子知道父母不会同意	见家长	F
反对结婚和女子的脸有关	见家长	F
男友是我爸妈的孩子	见家长	T
男友是我哥哥	见家长	T
是不是因为我的面相有重大改变	见家长	F
动物的脸	见家长	F
我的脸很晦气	见家长	F
因为他是变性人	见家长	F
这个女生是活人	见家长	T
我破相了	见家长	F
男友父母迷信	见家长	F
父母通过女孩脸上的胎记认出了这是之前的弃婴	见家长	F
我跟他父母长得很像	见家长	N
你和这家人是有血缘关系	见家长	T
你其实是男友的亲生妹妹么	见家长	T
同父异母	见家长	F
长得像死去的前女友	见家长	F
你的脸有任何不正常的	见家长	F
男友和我是亲人关系不可以近亲结婚	见家长	T
父母认识她的脸	见家长	T
是因为我是外国人	见家长	F
男友的爸爸出轨了	见家长	F
男友和女生有血缘关系	见家长	T
男人是杀人犯	见家长	F
女友长得像男友父母失散的女儿	见家长	F
女人长得和去世的人一样	见家长	F
男友有问题	见家长	F
男友父母想让我回到他的家	见家长	F
男朋友父母不喜欢我	见家长	F
他不是人	见家长	F
我脸上有烧伤	见家长	F
你是他们丢失的孩子	见家长	F
我和男友一见钟情是因为我们两个人是近亲长相相似所以才会一见钟情	见家长	N
他们是久别的兄妹	见家长	T
男友父母认识你的父母	见家长	T
我是男友爸妈的女儿	见家长	T
女友长得像死去的外婆	见家长	F
我是他们的孩子	见家长	F
你们有血缘关系	见家长	T
你的男友有残疾	见家长	F
男友是我的亲哥哥	见家长	T
女生戴面具了	见家长	F
我整容了	见家长	F
我们是亲生兄妹关系	见家长	T
男友父母认识她	见家长	T
和男友的妹妹长得一样	见家长	F
男友曾经杀过人	见家长	F
我是不是男友的妹妹	见家长	T
因为他是男的	见家长	F
女人是活人	见家长	T
和男朋友是兄妹	见家长	T
我长得太丑了	见家长	F
他是男生	见家长	T
梦里见过我	见家长	F
男子有失忆症	见家长	F
是幼女	见家长	F
我父母见过男友本人	见家长	T
他们是兄妹	见家长	T
男友不爱你	见家长	F
男友父母见过我本人	见家长	T
是因为我没化妆	见家长	F
我和我的男友有亲缘关系	见家长	T
他们是姐弟	见家长	T
你们合适	见家长	F
我是他妹妹	见家长	T
你是男友父母之前遗弃过孩子	见家长	F
你总感觉和他心有灵犀	见家长	T
你是父母的私生子	见家长	F
她毁容了	见家长	F
父母死了	见家长	F
女生看起来太年轻了	见家长	F
我曾经杀过人 我是一个杀人犯	见家长	F
他前女友长得和你一样	见家长	F
男友有一个妹妹	见家长	T
有人死了	见家长	F
男友是拐卖妇女的	见家长	F
我是私生女	见家长	F
女生脸正常	见家长	T
我是超生的	见家长	T
他们之前见过我的脸	见家长	T
我是他的亲人	见家长	F
男友是他父母的孩子	见家长	T
我的脸非常关建	见家长	F
我也是他们的孩子	见家长	T
男友的父母杀了人	见家长	F
抚养男友的家庭实际上是跟我有血缘关系	见家长	T
我长得像男友家里死去的孩子	见家长	F
女儿在网上做了好事	日记	F
律师函指控女儿杀人了	日记	F
时间线是对的	日记	T
女孩有生病	日记	N
好事是指赚到钱了	日记	F
女儿在裸聊	日记	F
女儿是在追星	日记	T
女儿的行为跟网络舆论相关	日记	T
我伤害了女儿	日记	F
女儿为明星花钱	日记	T
女儿是人	日记	T
女儿看电视电脑是为了追星	日记	T
父亲心理有问题	日记	N
女儿偷钱买疫情物资	日记	F
女儿网暴了别人或者被别人网暴了	日记	T
女儿想让我进监狱	日记	F
跟227事件有关	日记	T
女儿是沉迷于什么了	日记	T
女儿沉迷网游	日记	F
女儿倒卖了什么东西	日记	F
女儿朋友出事了	日记	F
她花钱有目的	日记	T
开销是女儿花的	日记	T
女儿花钱买了东西	日记	T
女儿是被告	日记	T
妈妈知道女儿开销大是用在什么地方	日记	F
6月买东西了	日记	T
女儿在追星	日记	T
女儿被我虐待了	日记	F
女儿的大好事是举报了一个网站	日记	T
女儿给明星花钱	日记	T
女儿要高考了	日记	F
我在网上监控女儿的上网行为	日记	F
女儿花了一大笔钱追喜欢的明星	日记	T
女儿成了性工作者	日记	F
女儿在卖东西	日记	F
家里的开销是女儿花的	日记	T
女儿和直播相关	日记	F
女儿失恋	日记	F
女儿不是亲生女儿	日记	N
女儿把人藏家里了	日记	F
女儿是我幻想的	日记	F
女兒是被冤枉的嗎	日记	F
女儿散播过各种言论	日记	T
女儿开销和明星有关	日记	T
网上认识的朋友骗了家里的钱	日记	F
女儿感染了新冠	日记	N
女儿被拉去做网络水军过	日记	T
开销特别大是因为冰箱藏尸	日记	F
开销大和女儿上网有关	日记	T
女儿为了买明星周边所以开销大	日记	T
时间线有问题	日记	F
女儿被校园霸凌了	日记	F
时间线反了	日记	F
女孩是背叛家庭了	日记	F
女儿没有母亲	日记	F
女儿交的朋友对她有好处	日记	F
女儿爱我	日记	N
女儿不上学和校园霸凌有关	日记	F
女儿粉肖战	日记	T
女儿参与了病毒传播	日记	F
女儿在赌	日记	F
和高考有关	日记	F
女儿被分尸了	日记	F
开销特别大是水费	日记	F
女儿是在上网课	日记	F
疫情期间女儿被网骗了	日记	F
女儿是疫情期间白天睡太多了	日记	N
女儿做的好事是关于我的	日记	F
女儿传染了疫情	日记	F
女儿认识了网友	日记	T
女儿有男朋友	日记	N
女儿买比特币	日记	F
开销是用来化妆了	日记	F
女儿搞网恋骗钱了	日记	F
女儿追星花太多钱	日记	T
禁足是指疫情被隔离了	日记	F
女儿去看病了	日记	F
女儿请律师	日记	N
女儿是键盘侠	日记	T
我让女儿禁足是为了她犯错误了	日记	T
女儿是受欺负了才不上学	日记	N
女儿吸毒	日记	F
女儿网络霸凌别人	日记	T
我是执法人员	日记	F
女儿参与了一些事件	日记	T
不是我女儿	日记	F
女儿自愿花钱	日记	T
女儿生病了	日记	F
女儿原来是肖战粉丝	日记	T
女儿的开销在电费上	日记	F
开销大是因为网费或电费	日记	F
女兒被禁足是懲罰她嗎	日记	T
女儿不能适应新高考改革	日记	F
女兒是被告嗎	日记	T
女儿恨我	日记	F
我虐待女儿	日记	F
女儿被侵犯了	日记	F
女儿是我的人格分裂	日记	F
女儿绑架了别人	日记	F
女儿举报别人了	日记	T
女儿为了追星用了很多家中的钱之后又去借钱	日记	N
涉及网络暴力	日记	T
女儿做的大好事真的是好事	日记	N
女儿炒股票了	日记	F
女儿的朋友的身份重要	日记	T
女儿眼睛出问题了	日记	N
女儿玩游戏	日记	F
女儿收到的律师函是关于朋友的	日记	F
我杀人了	日记	F
有人死了	日记	F
和明星有关	日记	T
律师函跟疫情有关	日记	F
女儿在炒股	日记	F
女儿是饭圈粉丝	日记	T
女儿参与犯罪了或者周围的人参与犯罪了	日记	T
女儿和同学闹矛盾了	日记	F
女儿把我禁足了	日记	F
女儿加入了某种团体	日记	T
女儿在网络上参加了不良的活动	日记	T
女儿沉迷于抵制ao3	日记	T
女儿喜欢唱跳rap和篮球	日记	N
女儿是间谍	日记	F
女儿喜欢过肖战	日记	T
女儿买基金	日记	F
和追星有关	日记	T
女儿是在网上和小团体聊天	日记	T
女儿和妈妈之间有一个人有精神问题	日记	F
女儿的朋友们是活人	日记	T
跟肖战有关	日记	T
女儿侵犯别人名誉了	日记	T
女儿虐猫	日记	F
女儿在自言自语	日记	F
女儿就是我	日记	F
女儿粉明星了	日记	T
这个故事中有人死亡	日记	F
女儿是在网络上开盒	日记	T
女儿把钱转给别人了	日记	F
女儿插足了别人家庭	日记	F
律師函是和女兒有關嗎	日记	T
写的不是女儿的名字	日记	F
女儿说的好事只是对于她的好事	日记	T
女儿创业失败	日记	F
女儿被人绑架了	日记	F
女儿是网红	日记	N
女儿是动物	日记	F
女儿因为花了我的钱收到律师函	日记	F
女儿的行为跟日期有关	日记	T
女儿利用网络做了坏事	日记	T
女儿抑郁	日记	F
女儿因为妈妈的原因状态恶化	日记	F
女儿偷偷把钱给朋友了	日记	F
女儿是尸体	日记	F
律师函跟家里开销大有关	日记	F
女儿抑郁症了	日记	F
女儿是活着的	日记	T
女儿贷款了	日记	N
女儿是假的	日记	F
女儿交很多男朋友	日记	F
女儿活着	日记	T
女儿的好朋友是真的身边的好朋友	日记	F
女儿沉迷网络直播打赏	日记	N
女儿是黑粉	日记	T
女儿在玩蓝鲸游戏	日记	F
女儿看电脑所以家里开销大	日记	F
女儿的行为对明星造成不好的后果了	日记	T
女儿结婚了	日记	N
那些朋友是网友	日记	T
开销大是因为女儿多用了电器	日记	F
女儿是瞎子	日记	F
女儿因为肖战犯法了	日记	T
女儿网上散播明星谣言	日记	T
女儿受所谓朋友的影响了	日记	T
涉及虚拟货币	日记	F
我是女儿的网友	日记	F
女儿做的事情涉及到营销了	日记	T
月份重要	日记	T
母亲有健忘症	日记	N
妈妈得病了	日记	F
女儿是穿越者	日记	F
女儿在赌球	日记	F
大好事是杀人	日记	F
禁足是和律師函有關嗎	日记	T
女儿每次出门都是干坏事	日记	N
女儿被监禁在求助	日记	F
女儿是通过网络和他人交流	日记	T
女儿是连环杀人犯	日记	F
和律师一起骗妈妈	日记	F
女儿花钱买凶了	日记	F
女儿换人了	日记	F
女儿和网友之间有什么特殊关系	日记	T
男人没有女儿是幻觉	日记	F
女儿怀孕	日记	F
女儿死了	日记	F
女儿网购欠债了	日记	F
女儿还是原来那个女儿	日记	T
女儿的行为跟上学或放假有关	日记	F
女儿捐款了	日记	F
女儿为了交朋友给他们花钱	日记	F
大好事是对明星粉丝的好事	日记	T
和女儿聊天的其实并不是身边朋友	日记	T
开销大是女儿花的钱	日记	T
我是家长	日记	T
女孩是网暴者	日记	T
是买演唱会的票了	日记	N
大好事是对家里的好事	日记	F
女儿是律师	日记	F
女儿追星 追的星是肖战	日记	T
大好事是对明星的好事	日记	T
我是不是精神有问题	日记	F
女儿用家里的钱去买东西了	日记	T
女儿沉迷投资	日记	F
女儿干了什么所以收到了律师函	日记	T
女儿参与某些违法的事	日记	T
女儿触犯法律了	日记	T
和妈妈有关	日记	F
禁足是因为女儿疫情严重了	日记	F
女儿收到律师函因为欠债	日记	F
女儿引导其他人自杀	日记	F
女儿不去上学和所处集体有关	日记	T
女儿把钱转给网友了	日记	N
女儿是未成年	日记	N
遇到的麻烦是指杀人被发现了	伪造	T
写的这几句话是同一个人写的嘛	伪造	T
这些话是一个人弄出来的	伪造	T
他遇到的麻烦和失望有关	伪造	T
我会被杀	伪造	F
我伪造不出第一个人的字迹	伪造	T
写信人追求我	伪造	F
我遇到的麻烦是我永远不会回来	伪造	F
这是一个人日记的内容	伪造	T
男人在模仿别人的笔记	伪造	T
我考试没考好	伪造	F
这是动物学说的话	伪造	F
我模仿了别人的试卷	伪造	F
是男人在重复某个行为	伪造	T
这是夫妻一方给另一方留下的留声机	伪造	F
男人是gay	伪造	N
他遇到了麻烦	伪造	T
模仿演员	伪造	F
故事里有6个人	伪造	F
是一个男人永远不会回来了	伪造	F
我永远也不会回来了	伪造	F
我是个孩子	伪造	N
是有人在学我说话	伪造	F
是真的永远不会回来了	伪造	T
这是两个人分手时的对话	伪造	F
这个人回来过	伪造	F
所有话都是一个人说的	伪造	T
某人的电话彩铃是这句话一直播放	伪造	F
有人陷害我	伪造	F
我会死亡	伪造	N
他旁边是不是有个人	伪造	N
这个人是在背书	伪造	F
是上司对下属说的话	伪造	F
这个人的字迹越来越潦草了	伪造	N
男子死了	伪造	F
他自己写的	伪造	T
是情侣之间的对话	伪造	F
麻烦跟文字内容有关	伪造	F
有回音	伪造	F
我知道我可能遇到麻烦了	伪造	T
是我收到的短信	伪造	F
我模仿不了字迹	伪造	T
和对方玩复述说话的游戏	伪造	F
是多个人写的	伪造	F
他遇到的麻烦跟失望有关	伪造	F
说这些话的人是我的女朋友	伪造	F
写这些话的人杀人了	伪造	T
主角被亲人抛弃了	伪造	F
这是另外一个人给我写的	伪造	F
打字机故障	伪造	F
这些是别人说的话	伪造	F
妻子真的永远离开了	伪造	T
这些话是纸上的	伪造	T
人疯了	伪造	F
一个人杀了另一个人想伪造遗书但是怎么都写不好	伪造	T
故事里有小孩子	伪造	F
我杀了人	伪造	T
这件事牵扯了命案	伪造	T
是我的前女友们写的	伪造	F
男人杀了女人然后伪造女人的死因	伪造	T
故事有两个人	伪造	T
两个人分手了	伪造	F
信件的笔记是同一个人写的	伪造	T
这些话是两个人说的	伪造	F
写出这些话的人自杀了	伪造	F
对方自杀了	伪造	F
我在模仿我死去的哥哥	伪造	F
我是否惹恼了写字的人	伪造	F
这份笔记是一个一个人传递来的	伪造	F
模仿的是字迹	伪造	T
我远行了	伪造	F
是他的妻子写的	伪造	F
麻烦是后果严重的	伪造	T
我伤害了别人	伪造	T
这个人不回来我会死	伪造	F
故事里有三个人	伪造	F
写这些话的人死了	伪造	F
对我失望的人是我的妻子	伪造	F
重复发出声音的事人	伪造	F
男子被人伤害了	伪造	F
我做了事让别人死了	伪造	T
死掉的是写这部分文字的人	伪造	F
是我写的话	伪造	T
男人是不是有病	伪造	N
遇到的麻烦是可能杀人会被发现	伪造	T
主角会死	伪造	N
说这句话的那个人还会再回来	伪造	F
男人被女人诬陷了	伪造	F
我杀了人 正在伪造遗书	伪造	T
是一个女人永远不会回来了	伪造	T
我在模仿电视或者电影里的故事	伪造	F
我老年痴呆了	伪造	F
我老婆跑了	伪造	F
这些话是他自己写的	伪造	T
他在模仿妻子字迹	伪造	T
他在模仿他的上司	伪造	F
我被催婚太厉害不想回家	伪造	F
我在伪造证件	伪造	F
是写下来的	伪造	T
他死了	伪造	F
我妻子被绑架了	伪造	F
我模仿别人的字	伪造	T
我的麻烦是我要变成别人	伪造	F
是机器坏了	伪造	F
我杀了妻子 伪造证据	伪造	T
重复发出声音的是录音	伪造	F
我在重复地过同一天	伪造	F
是一个精神有问题的人的喃喃自语	伪造	F
我有精神分裂	伪造	F
这几句话是不同的人写的	伪造	F
他杀了对方这样就可以不用离开他 也可以永远在一起了	伪造	F
我杀了人想模仿死者的笔记伪造出他离家出走的证据但试了很久还是不像所以我觉得会被看出来因此很麻烦	伪造	T
我以为我可以成功回到女友身边	伪造	F
短信是家人发的	伪造	F
有人寻仇	伪造	F
有人在我面前模仿别人	伪造	F
我杀了妻子 伪造证据 模仿妻子笔记 但是学不来	伪造	T
是父母失望了	伪造	F
我不想对方离开杀了对方	伪造	T
我模仿着死去的那个人的字迹	伪造	T
这六句话是一个人写的	伪造	T
男人男扮女装	伪造	F
这句话是恋人对我说的	伪造	F
我写出的笔迹与想象的不一样	伪造	T
我遇到的麻烦是我失去了6个家人朋友	伪造	F
是我的妻子死亡	伪造	T
这是谁留给我的信息	伪造	F
麻烦是警察会来找我	伪造	T
这些话是文字	伪造	T
这是我的日记	伪造	F
我杀了说话的人	伪造	F
说这句话的人精神出现了问题	伪造	F
是我的女朋友留给我的信息	伪造	F
男子模仿妻子	伪造	T
故事里是否存在有人患阿兹海默症	伪造	F
他在读别人的遗书	伪造	F
女人伪造自杀诬陷男人但被男人发现于是把女人杀了	伪造	F
我女朋友跑了	伪造	F
信是我认识的人给我的	伪造	F
这些笔迹不是我写的	伪造	F
每次说这句话得人都会死	伪造	F
是欠债了	伪造	F
是我伪造别人的口吻写的	伪造	T
是他考试考砸了	伪造	F
我遇到了一个一直模仿我的人	伪造	F
是家长跟孩子的对话	伪造	F
留言的人死了	伪造	F
主角有双重人格	伪造	F
对方死了死前电话里说的	伪造	F
有鬼	伪造	F
他是厨师	伪造	F
是鹦鹉	伪造	F
是我杀了那个死亡的人	伪造	T
是他在模仿别人的字迹	伪造	T
麻烦指的是这句话永远不会消失	伪造	F
文字是我伪造的	伪造	T
我杀了妻子伪造字迹但是写不对	伪造	T
他要模仿的是他妻子的字迹	伪造	T
遇到麻烦的我死了	伪造	F
信是我写的	伪造	T
这是两个人的对话	伪造	F
是我出柜了	伪造	F
我还活着	伪造	T
情感问题	伪造	N
男子遇到困难了	伪造	T
我是作家	伪造	F
他的挚爱自杀了	伪造	F
我不认识字	伪造	F
笔迹是我模仿的	伪造	T
对方模仿我以前说过的话	伪造	F
我上司跑了	伪造	F
遇到麻烦的这个人死了	伪造	F
我目睹了凶杀案	伪造	F
是收音机或者电视卡住了	伪造	F
是老师写的	伪造	N
这个人被辞职了	伪造	F
是有人闯祸了	伪造	T
男人出轨了于是女人假装被男人杀了诬陷他杀人	伪造	F
这些话的内容重要	伪造	T
男人是不是出轨了	伪造	N
男人穿女人衣服被发现了	伪造	F
麻烦是指犯法了	伪造	T
我被人盯上了	伪造	F
内容重要	伪造	T
有很多人在说同一句话	伪造	F
这个所谓不会回来的我和遇到麻烦的我是两个人	伪造	T
有人离家出走了	伪造	F
我试图伪造些什么	伪造	T
他太吵闹了我把他杀死	伪造	F
别人模仿我的笔迹成功后要处理掉我	伪造	F
事件与死亡有关	伪造	T
我先对别人说对方又对我说	伪造	F
家人愚人节开玩笑	伪造	F
人还会回来	伪造	F
他是伪造	伪造	T
我杀死了妻子	伪造	T
我在学习相声演绎	伪造	F
他们住的房子楼层只有1237	1237	F
她住七楼	1237	N
我看到了小朋友家里的情况	1237	T
这串号码和妈妈的手机号码有关	1237	F
漏掉的数字是死人数	1237	F
和视觉有关	1237	F
和妈妈有关	1237	T
妈妈不想告诉小朋友真相	1237	T
不说1237的人死了	1237	F
家访时我知道了为什么小朋友总说123后面是7	1237	T
妈妈让她拔掉生命维持机器的第几根电线	1237	F
妈妈是精神病	1237	F
死了6个人	1237	F
妈妈缺失记忆	1237	F
1237是再见的意思	1237	F
她妈妈有病并且已经活不长久了	1237	T
小朋友有问题	1237	F
我也说1237是被洗脑了么	1237	F
他是单亲家庭	1237	N
1237是手机尾号	1237	F
小朋友有缺陷	1237	F
我受到伤害了	1237	F
妈妈是癌症晚期	1237	F
小朋友家的电梯里没有中间的几层	1237	F
她妈妈不会说456	1237	F
妈妈没有舌头	1237	F
小朋友的妈妈有口音	1237	F
我这样数的原因与她的妈妈有关	1237	T
他妈妈是不是真的	1237	T
女孩的妈妈是出于善意才这么教女孩的	1237	T
妈妈患有心脏病想要陪孩子过生日	1237	T
她是第七个孩子	1237	N
妈妈的精神正常	1237	T
妈妈被虐待了么	1237	F
妈妈想求救	1237	F
小朋友有七个家长	1237	F
他家里有七个房间	1237	N
她妈妈有病 为了给女孩过生日	1237	T
妈妈快病死了	1237	T
家里一共有七个人	1237	N
妈妈生病住院了	1237	T
妈妈有痴呆症	1237	F
1237是某样东西的密码	1237	F
小朋友是孤儿	1237	F
妈妈家里有7个尸体	1237	F
小朋友家里有四个人	1237	N
和自己逝世的亲人有关	1237	F
他爸爸家暴	1237	N
家里除了小朋友还有人活着	1237	T
他妈妈会在3月死 但7月是女孩生日	1237	N
妈妈记忆错乱	1237	F
病床没有456号	1237	N
妈妈是傻子	1237	F
家访时是父亲在家	1237	F
1237的含义重要	1237	T
家访完后我疯了	1237	F
妈妈患有疾病	1237	T
小朋友其实是大人	1237	F
妈妈是不是离婚了	1237	N
小朋友是智力障碍	1237	F
小女孩有三个家人死了	1237	N
他妈妈已经去世了	1237	F
小朋友耳朵有问题	1237	F
小朋友妈妈的手指有缺陷	1237	F
小孩不可以说4 是么	1237	F
家访是不是遇到了危险	1237	F
女孩的妈妈是聋哑人	1237	F
母亲生了7个孩子	1237	F
456不能提起	1237	F
456和谐音有关	1237	F
小朋友是跟玩偶学的	1237	F
妈妈怀孕了	1237	F
因为妈妈从小数学不好	1237	F
妈妈活着	1237	T
老四老五老六死了	1237	F
小朋友是有意要这么数数	1237	F
小朋友的妈妈有数字识别障碍	1237	F
爸爸活着	1237	N
原来她妈妈患有心脏病并且已经活不长久了而现在是三月份而她的女儿生日在七月份为了能陪伴她的女儿过最后一个生日才对她的女儿编制了这样一个善意的谎言	1237	T
妈妈是机器人	1237	F
母亲在周四周五周六要去医院	1237	F
家访地点是她家里	1237	F
家访中我见到了小朋友的妈妈	1237	T
她妈妈会催眠	1237	F
她妈妈故意的这么教的	1237	T
我遇到危险了	1237	F
我被威胁了	1237	F
妈妈是周一周二周三周日需要去干什么	1237	F
他妈精神有问题	1237	F
456对妈妈有伤害	1237	F
是不是家里量身高的刻度	1237	F
数字跟星期有关	1237	F
和爸爸有关	1237	F
我被迫说1237	1237	F
妈妈的病是绝症	1237	T
今天有人死了	1237	F
爸爸把456带走了	1237	F
漏掉的数字本身和事件关联很大	1237	T
妈妈不认识4和5	1237	F
1237是门牌号	1237	F
妈妈有病	1237	T
因为四五六是我和她还有她妈	1237	F
妈妈健康么	1237	F
是因为他妈妈手指头没办法比出456	1237	F
我被传染了	1237	F
小朋友的妈妈是被拐卖的	1237	F
和小朋友的家人有关系	1237	T
数数是她妈妈教给她的	1237	T
是为了小朋友才故意漏掉这些数字	1237	T
单亲家庭	1237	N
1237和他家里的东西有关	1237	F
小朋友健忘	1237	F
有人死了	1237	F
妈妈真的是他的妈妈	1237	T
妈妈手指残疾	1237	F
这个妈妈控制了老师的思想	1237	F
女孩这么数数是为了她自己的安全考虑	1237	F
她妈妈是不是活不久了	1237	T
小朋友附身在我身上了	1237	N
妈妈是故意漏掉456的	1237	T
孩子家人得了病	1237	T
小孩只有四个手指	1237	F
孩子要做手术	1237	F
我是因为被感动到了才这么说的	1237	T
我家访的时候没有见到女孩的妈妈	1237	F
孩子妈妈很可能活不到7月了	1237	T
妈妈是说不出这几个数字	1237	F
因为妈妈要死了 骗小朋友 为了陪她过生日	1237	T
小朋友是故意的	1237	F
妈妈故意说谎的	1237	T
妈妈病情严重	1237	T
她妈妈不会正确的数数	1237	F
她妈妈的生日在七月	1237	N
妈妈少手指头	1237	N
小朋友是头胎	1237	N
妈妈是故意这样教的	1237	T
妈妈确实认为123的下一个是7	1237	F
和听觉有关	1237	F
我被人砍了	1237	F
妈妈要提前给小女孩过生日	1237	T
妈妈是脑瘫 不会数数	1237	F
孩子有缺少的兄弟姐妹	1237	N
妈妈的想法很有感染力	1237	T
她爸爸还活着	1237	N
小朋友的爸爸家暴	1237	N
这几个数字代表家庭成员	1237	F
孩子要死了	1237	F
她妈妈是故意说错	1237	T
是爸爸死了	1237	N
数字是人	1237	F
我也是为了圆孩子妈妈得善意的谎言	1237	T
女孩的关键住址信息和1237有关	1237	F
妈妈在家里	1237	F
数字代表人	1237	F
他没有爸爸	1237	N
456跟时间有关系	1237	T
妈妈教她这个是为了让小朋友保护自己	1237	F
他妈妈失去了三个小孩	1237	F
我被洗脑了	1237	F
妈妈会数正确的数	1237	T
妈妈是为了小孩好么	1237	T
这是年龄	1237	F
是拐卖来的孩子	1237	F
女孩提到456的时候会发疯	1237	F
小朋友妈妈是1237号床	1237	F
1237是小朋友的名字	1237	F
7月是孩子的生日	1237	T
妈妈生病了不知道456	1237	F
456代表的人被杀了	1237	F
妈妈生病付不起医药费	1237	F
孩子有智商问题	1237	F
数字是月份	1237	T
是我家访见到的东西改变我的想法了	1237	T
孩子母亲心脏病就快要逝世了但现在才三月孩子的生日是在七月所以母亲为了不让孩子伤心所以骗他三月后就是7月	1237	T
家访发现孩子七月过生日	1237	T
他妈妈想让老师关注他	1237	F
家里除了妈妈还有别人	1237	N
是我自己去的家访	1237	T
妈妈得了心脏病 只能活那么久了 在等女孩的生日	1237	T
数的数字是她妈妈得病的时间	1237	F
妈妈是智力障碍	1237	F
这是他们的暗号	1237	F
7跟女孩生日相关	1237	T
他们住的是电梯房没有到456楼的电梯因为四层五层六层是商业用地或者是其他用地	1237	F
这个数字跟宗教有关系	1237	F
妈妈要死了	1237	T
家访时我知道了些什么	1237	T
除了她妈妈还有人死了	1237	F
家访时只有小朋友在家	1237	F
我的朋友被当成鱼饵了	鱼	T
鱼吃过他的爱人	鱼	N
用死去的人做诱饵去钓鱼我对鱼产生了恐惧	鱼	T
鱼会让你想起一些可怕的往事	鱼	T
我是看到鱼杀死某人才觉得鱼恶习	鱼	F
他曾经吃过太多鱼	鱼	F
我吃过鱼肉	鱼	T
水手差点被鱼吃掉	鱼	F
水手之前遇到过海难被困住的时候朋友骗我吃鱼肉实际不是鱼肉	鱼	F
鱼饵是蚯蚓 我觉得恶心	鱼	F
水手用尸体的肉钓过鱼	鱼	T
是因为鱼的长相	鱼	F
水手是人	鱼	T
鱼是指水里的鱼	鱼	T
有人死了	鱼	T
我被鱼咬过	鱼	N
他用鱼杀死过人	鱼	F
我的肉被当成鱼饵	鱼	F
水手和鱼有过性关系	鱼	N
鱼是人	鱼	F
目睹船员自相残杀	鱼	N
有人用冻鱼杀人	鱼	F
我曾经被作为鱼饵	鱼	F
他只是不喜欢吃鱼	鱼	F
我曾杀过人	鱼	N
船上出了事情我吃人肉存活	鱼	F
我见过鱼吃了我的伙伴	鱼	T
是不是遇到过食人鱼	鱼	F
凶手把尸体伪装成鱼	鱼	N
死的人和鱼有关	鱼	N
我在鱼里吃出过什么东西	鱼	F
鱼是他幻想出来的嘛	鱼	F
我水手身份重要	鱼	T
当水手的时候把鱼当成了其他东西	鱼	F
他目睹过和鱼相关的非常负面的事情	鱼	T
鱼太腥了	鱼	F
看到鱼会联想到之前经历过的恐怖事情	鱼	T
鱼饵是鱼的同类	鱼	F
水手遇到过海难吃了人肉对外称是鱼肉	鱼	F
这是海盗船所以水手也是海盗吧	鱼	F
我精神有异常	鱼	N
杀鱼太多了	鱼	F
我当水手的时候被鱼伤害过	鱼	F
水手转业去杀鱼了	鱼	F
水手的伙伴不喜欢鱼	鱼	N
鱼饵是用船员尸体做的	鱼	T
用同伴的肉钓鱼	鱼	T
我知道鱼的诱饵的成分所以觉得鱼很恶心	鱼	T
水手是他幻想出来的工作	鱼	F
我一直对鱼感到害怕	鱼	F
我见到有人被鱼分尸	鱼	F
水手拿冻鱼杀过人	鱼	F
我怕鲨鱼	鱼	N
我是从小就害怕鱼	鱼	F
吃鱼被鱼刺卡过留下阴影	鱼	F
是因为在当水手时发生了某事导致我讨厌鱼	鱼	T
落水过	鱼	N
他因为鱼杀过人	鱼	N
鱼饵是什么重要	鱼	T
我曾目睹鱼吃掉我的伙伴	鱼	T
鱼是人作为诱饵钓上来的	鱼	T
鱼会让他想到不好的事情	鱼	T
曾经用人肉钓鱼	鱼	T
水手的同胞被鱼刺卡过	鱼	F
是因为有过痛苦经历	鱼	T
鱼是鲨鱼	鱼	F
在船上天天吃鱼吃太多了	鱼	F
鱼特别大	鱼	N
是不是曾经吃过人肉	鱼	N
鱼救过他	鱼	F
他在船上是厨师	鱼	N
我是不是见过用人当诱饵钓鱼	鱼	T
鱼给他留下了一段不美好的印象	鱼	T
是他的伙伴死了	鱼	T
有没有超自然因素	鱼	F
遇到海难了	鱼	T
跟死人有关	鱼	T
水手伙伴是因为鱼死的	鱼	N
我看到的不是正常的鱼	鱼	F
他当水手的时候也害怕鱼	鱼	N
水手的一些伙伴死了	鱼	T
我觉得鱼恶心	鱼	T
自己养的鱼死了	鱼	F
鱼是指海龟	鱼	F
吃过人肉	鱼	N
我吃过活鱼	鱼	F
水手是因为一次经历开始害怕鱼的	鱼	T
他差点淹死	鱼	N
做水手的时候见过鱼吃人	鱼	F
他发生过船难	鱼	T
他真的是水手	鱼	T
他杀过人	鱼	N
我对海鲜过敏	鱼	F
遇上海难	鱼	T
他把老婆杀了喂鱼	鱼	F
他晕船	鱼	F
曾经有在海上没有别的食物只能吃鱼过	鱼	F
曾经出海的时候把同事当成鱼吃掉了	鱼	F
水手曾经爱上了鱼	鱼	F
被鱼打过	鱼	F
水手曾经被丢到海里	鱼	N
曾经有人死了	鱼	T
我是因为吃鱼而导致别人死亡了	鱼	F
鱼吃了同伴	鱼	T
他家人被鱼害过	鱼	F
同伴的死是我间接导致的	鱼	N
有人死了然后被打扮成了鱼	鱼	F
当水手的时候遇到了鱼妖	鱼	F
我看到的鱼是普通的鱼	鱼	T
鱼是真的鱼	鱼	T
有人死了被做成鱼饵	鱼	T
他看见了食人鱼	鱼	F
我是被迫去当水手的	鱼	N
我曾经躲在鱼里	鱼	F
他看见过死人	鱼	T
水手怕水	鱼	N
鱼以前导致过什么人死亡	鱼	F
水手因为某件事害怕鱼	鱼	T
他杀了他的水手同事	鱼	F
鱼饵的原料不正常	鱼	T
是鱼让他最后不做水手了	鱼	N
水手吃的是人鱼	鱼	F
我打破过鱼缸	鱼	N
鱼会说话	鱼	F
水手吃鱼吃腻了	鱼	F
在海上经历一些事情最后吃鱼存活	鱼	T
有鱼的地方风浪大	鱼	N
水手 对鱼过敏	鱼	F
零食里有死人	打折的零食	N
新闻里有卖货者	打折的零食	T
他看新闻发现小卖部店主在昨天前就已经死亡了	打折的零食	T
这是无人超市	打折的零食	F
新闻内容重要	打折的零食	T
主角意识到自己要死了	打折的零食	F
新闻报道中小卖部出事了	打折的零食	T
卖给他零食的人有问题	打折的零食	T
新闻是凶杀案	打折的零食	T
零食是质量有问题	打折的零食	N
打折零食有问题	打折的零食	N
卖货者是新闻发布人	打折的零食	F
新闻和卖货者相关	打折的零食	T
卖东西的人很有可能不知道价格	打折的零食	T
食物过期了	打折的零食	N
他看到的店员是杀人犯	打折的零食	T
零食的原料有问题	打折的零食	N
这批零食是销赃的	打折的零食	N
新闻跟卖货老板有关	打折的零食	T
他被吓傻和零食本身有关	打折的零食	F
那個小賣部的老闆已經死了	打折的零食	T
小卖部当时里面有杀人犯	打折的零食	T
零食来源是血腥的恐怖的	打折的零食	N
卖货者杀了小卖部原有的老板	打折的零食	T
卖者者是杀人犯	打折的零食	T
小卖部老板被杀凶手伪装成老板	打折的零食	T
是因为零食	打折的零食	F
零食坏掉了	打折的零食	N
售货员是凶手	打折的零食	T
卖货者有艾滋病	打折的零食	N
店员是假的	打折的零食	T
卖给他货的人不是老板	打折的零食	T
有人死了	打折的零食	T
小卖部真正的售货员被凶手杀害凶手假装成售货员而他不知道零食的价格所以卖的便宜	打折的零食	T
新闻是犯罪相关	打折的零食	T
卖货者是真正的老板	打折的零食	F
打折零食是用不健康的东西做的	打折的零食	N
卖零食的人是嫌疑犯	打折的零食	T
卖货者是无良商家	打折的零食	N
店主是坏人假扮的杀了原店主	打折的零食	T
新闻里小卖部被打劫了	打折的零食	T
零食是抢来的	打折的零食	F
超市里有凶杀案买的东西可能是尸体	打折的零食	F
卖货的人有问题	打折的零食	T
是买了打折零食的人死了	打折的零食	F
售货员是假扮的当时他可能在实施犯罪 因此他不一定知道零食的真正价格	打折的零食	T
零食其实是人肉做成的	打折的零食	N
零食日期是伪造的	打折的零食	N
卖他的人不是收银员	打折的零食	T
小卖部店主还活着	打折的零食	F
卖货者是把自己身体一部分当做零食来做了	打折的零食	F
打折零食对人体不好	打折的零食	N
新闻里有人死了	打折的零食	T
涉及灵异	打折的零食	F
打折零食里面装的是真的零食	打折的零食	T
零食是合法的	打折的零食	N
小卖部开在他床底下	打折的零食	F
卖零食的人不是店员	打折的零食	T
零食里有别的东西	打折的零食	N
卖打折零食的人有没有问题	打折的零食	T
老板在我买零食之后被杀了	打折的零食	N
新闻的内容跟这批零食有关系	打折的零食	F
和售货员有关系	打折的零食	T
这些零食并不是真的零食	打折的零食	F
没有人死亡	打折的零食	F
卖家跑路	打折的零食	F
这批零食有毒	打折的零食	N
是因为非正常原因打折	打折的零食	T
他去的小卖部遭遇了抢劫	打折的零食	T
卖货者调包了零食	打折的零食	N
卖货者出现在新闻报导里了	打折的零食	T
小卖部的老板在我买零食的时候已经遇害了	打折的零食	T
食物是人做的	打折的零食	F
其实那个售货员是杀人犯假扮的 如果当时主角发现了这一点他可能也会被挟持	打折的零食	T
尸体被肢解了	打折的零食	N
卖货者是警察之类的	打折的零食	F
卖货者有问题么	打折的零食	T
结账的人随意报价让人误以为打折	打折的零食	N
打折零食是真的零食	打折的零食	T
小卖部老板不是本人不一定清楚价格	打折的零食	T
死的是老板	打折的零食	T
超市出售假货	打折的零食	N
打折零食是人体器官	打折的零食	N
零食里有被切下来的手指	打折的零食	N
卖货者不是老板	打折的零食	T
女儿买东西给别人	日记 	F
